ابين	أَبان,بَيَّن,أَبْيَن,آبِي,أَبَى-َ,بان-ِ
ابيورد	MANVER3BW
اذربيجان	MANVER3BW	MAN
اران	MANVER3BW
اربل	MANVER3BW
ارجان	أَرِج
اردبيل	MANVER3BW	MAN
ارزن	رَزُن
ارمينية	MANVER3BW
استجة	MANVER3BW
استراباذ	MANVER3BW
استوا	MANVER3BW
اسفرايين	MANVER3BW
اسوان	أَسْوان
اشبيلية	MANVER3BW	MAN
اشروسنة	MANVER3BW
اصبهان	MANVER3BW
اصطخر	MANVER3BW
افريقية	MANVER3BW	MAN
الابنية	بِناء
الابواء	MANVER3BW
الاردن	MANVER3BW	MAN
الاسكندرية	MANVER3BW	MAN
الانبار	أَنْبار,نِبْر
الاندلس	MANVER3BW	MAN
الاهواز	MANVER3BW	MAN
البادية	بادِيَة,بادِي
البحرين	MANVER3BW	MAN
البربر	بَرْبَرِيّ
البصرة	MANVER3BW	MAN
البلقاء	أَبْلَق
البهنسا	MANVER3BW
البيرة	MANVER3BW	MAN
الثعلبية	ثَعْلَبِيّ
الثغور	ثَغْر
الجار	جار
الجبال	جَبَل
الجبل	جَبَل
الجحفة	MANVER3BW
الجزيرة	جَزِيرَة
الخضراء	أَخْضَر
الجند	جُنْد
الحبشة	حَبَش
الحجاز	حِجاز
الحجر	حُجْرَة,حَجَر,حِجْر,حَجْر
الحجون	MANVER3BW
الحربية	حَرْبِيّ
الحزن	حَزْن,حُزْن
الحمى	حُمَة,حَم,حَمِيّ,حِمَى,حُمَّى,حُمِّيّ
الحيرة	حَيْرَة
الخابور	MANVER3BW	MAN
الخراب	خَراب
الخزر	خَزَر
الديلم	MANVER3BW
الدينور	MANVER3BW
الرحبة	رَحْبَة,رَحْب
الرصافة	رَصّاف,رَصافَة
الرقة	رِقَّة
الرملة	MANVER3BW	MAN
الروم	رَوْم,رُوم
الري	رَيّ
الريف	رِيف
الزاب	MANVER3BW
الساحل	ساحِل
السند	سِنْد,سَنَد
السواد	سَواد
السودان	سُودان
السوس	سُوس
الشاش	MANVER3BW	MAN
الشام	MANVER3BW	MAN
الشراة	شارِي
الصعيد	صَعِيد
الصين	صِين
الطائف	MANVER3BW	MAN
العذيب	MANVER3BW
العراق	MANVER3BW	MAN
العقبة	عَقَبَة
العقيق	عَقِيق
العواصم	MANVER3BW	MAN
الغور	غَوْر
الغوطة	MANVER3BW	MAN
الفرات	فُرات
الفرس	فَرَس,فارِسِيّ
الفرما	MANVER3BW
الفسطاط	MANVER3BW	MAN
الفيوم	MANVER3BW	MAN
القادسية	MANVER3BW	MAN
القاهرة	قاهِرَة
القسطنطينية	قMANVER3BW	MAN
القلزم	MANVER3BW
القيروان	MANVER3BW	MAN
الكرخ	MANVER3BW
الكوفة	MANVER3BW	MAN
اللوى	لَوَى,لَيَّة,لِوَى
المدائن	مَدِينَة,مَدائِن
المدينة	مَدِينَة,مَدِين,مُدِين
المرية	مُرْيَة
المصيصة	MANVER3BW	MAN
المغرب	مَغْرِب,مُغَرَّب
المهدية	مُهْدِي,مَهْدِيّ
الموصل	مَوْصِل,مُوَصِّل
النعمانية	MANVER3BW
النهروان	MANVER3BW
النيل	نِيل,نَيْل
الهند	MANVER3BW	MAN
اليمامة	يَمام
اليمن	يُمْن,يَمَن
امد	أَمْدَى,ماد-ِ,مَدّ,أَمْبِير,أَمَدّ
امرة	أَمْر,مار,مار-ِ,أَمَّر,أَمَرّ,مَرّ,آمَر,أَمار,إِمْرَة,آمِر,أَمَر
امل	مَلَّى,مَلّ-َ,أَمَل-َ,آمِل,أَمال,أَمْلَى,أَمَّل,أَمَلّ,مال-ِ,مَلا,أَمَل
انطاكية	أMANVER3BW	MAN
ايلة	آيِل,أَيِّل
باب الابواب	MANVER3BW	MAN
باب	آب,أَب,باب,إِبّ
البصرة	MANVER3BW	MAN
باجة	MANVER3BW	MAN
بالس	MANVER3BW
بانياس	MANVER3BW	MAN
بخارى	بُخار,بُخارِيّ
برذعة	بَرْذَعَة
برقة	رَقّ,رِقّ,بَرْق,رِقَّة,بَرَق,بَرْقَة
بست	باس,سِتّ,بَسّ
بسطام	سِطام
بصرى	بَصْرِيّ,بَصَرِيّ,بَصَر
بطليوس	MANVER3BW	MAN
بعلبك	عMANVER3BW	MAN
بغداد	MANVER3BW	MAN
الترك	تَرْك,تُرْكِيّ
بلخ	MANVER3BW
بلنسية	MANVER3BW	MAN
بيت المقدس	MANVER3BW	MAN
البيت المقدس	مMANVER3BW	MAN
بيهق	MANVER3BW
تبريز	تَبْرِيز
تدمر	دَمَر,دَمَّر,تَدْمُر,تَدَمَّر
تركستان	MANVER3BW	MAN
ترمذ	MANVER3BW
تفليس	تَفْلِيس
تكريت	تَكَرَّى,تِكْرِيت
تلمسان	تِلِمْسان,لَمَس
تنيس	تِنِس
تهامة	MANVER3BW	MAN
تونس	تُونِس,تَوْنَس
تيماء	تَيْماء
جبال	جَبَل
جبلة	جِبْلَة,جَبَل,جِبِلَّة,جَبْلَة
جرجان	MANVER3BW
جزيرة ابن عمر	عMANVER3BW	MAN
جهينة	جُهَيْنَة,جَهِي-َ
جيان	MANVER3BW
جيحون	river
جيلان	MANVER3BW	MAN
حجر	حُجْرَة,حَجَر,حَجَّر,حَجْر,حِجْر
حران	حُرّ,حَرّان
حضرموت	MANVER3BW	MAN
حلب	حَلَب,حَلَب-ُِ,حَلْب
حلوان	حُلْوان,حُلْو
حما	حَم,حَمّ
حماة	MANVER3BW	MAN
حمص	حِمْص,حَمَّص,حُمُّص
حمى	حَمِي-َ,حُمَة,حَم,حَمِيّ,حِمَى,حُمِّيّ,حَمَى-ِ,حُمَّى,حَمَّى
حمير	حِمار
حوران	MANVER3BW	MAN
خثعم	MANVER3BW
خراسان	MANVER3BW	MAN
خلاط	خَلّاط
خوارزم	MANVER3BW
خوزستان	MANVER3BW	MAN
خولان	MANVER3BW
خيبر	MANVER3BW	MAN
دجلة	دَجْل,دَجَل,دَجَّل,دِجْلَة
دجيل	MANVER3BW
دمشق	MANVER3BW	MAN
دمياط	MANVER3BW	MAN
دهستان	MANVER3BW
راس عين	عMANVER3BW	MAN
رية	رِئَة,رَيّ
زبالة	زَبّال,زُبالَة
زبيد	MANVER3BW	MAN
زنجان	MANVER3BW
زويلة	MANVER3BW
سارية	سارِيَة,وَرَى-ِ,سارِي,سارّ
سجستان	MANVER3BW
سر	سُرّ,سِرّ,سَرّ
سرخس	MANVER3BW	MAN
سرقسطة	MANVER3BW	MAN
سلمى	سُلَّم,سِلْمِيّ,سَلْمَى,سِلْم
سلمية	سُلَّم,سِلْمِيّ
سمرقند	MANVER3BW	MAN
سميساط	MANVER3BW
سنجار	جارَى,أَجار
سيراف	MANVER3BW
شروان	MANVER3BW
شهرزور	MANVER3BW
شيراز	MANVER3BW	MAN
صعدة	صَعِد-َ,صَعِيد,صَعْدَة,صَعَّد
صقلية	MANVER3BW	MAN
صنعاء	MANVER3BW	MAN
صور	صَوَّر,صُورَة,صُور
صيداء	MANVER3BW	MAN
طبرستان	MANVER3BW
طبرية	MANVER3BW	MAN
طبس	MANVER3BW
ا?طرابلس	MANVER3BW	MAN
طرسوس	MANVER3BW
طليطلة	MANVER3BW	MAN
طوس	طَوَّس
عثر	عَثَّر,عَثَر
عدن	عَدْن,عاد
عذرة	عُذْرَة,عُذْر,عَذَر-ِ
عزاز	MANVER3BW
عسقلان	MANVER3BW	MAN
عكا	عَكَّة,عَكّ
عمان	عَمّ,عُمان,عَمّان
عير	عَيْر,عَيَّر
عين	عَيَّن,عَيْن
التمر	تَمْر
غرناطة	MANVER3BW	MAN
غزة	غَزَّة
غزنة	MANVER3BW
فارس	رَسا,رَسَّى,فارِس,أَرْسَى,أَرَس-ِ
فاس	أُسّ,آسِي,آس,إِس,فاس
فدك	دَكّ
فرغانة	MANVER3BW
فزارة	فَزارَة,زار
فلج	لُجّ,لَجّ-َِ,فَلَج-ِ,فَلْج,فَلَج,فَلَّج
فلسطين	MANVER3BW	MAN
فيد	يَد,وَدَى-ِ
قاشان	MANVER3BW
قديد	قَدِيد
قرطبة	MANVER3BW	MAN
قرمونة	MANVER3BW
قرن	قِرْن,قَرْن,قَرَن-ِ,قُرْنَة
قزوين	MANVER3BW	MAN
قطربل	MANVER3BW
قم	قَمّ
قنسرين	MANVER3BW
قهستان	MANVER3BW
قوص	MANVER3BW
قومس	MANVER3BW	MAN
قيس	قَيَّس,قَيْس
قيسارية	MANVER3BW
كابل	كابُل,إِبْل,كابِل,كابَل
كاظمة	كاظِم,كاظِمَة
كرمان	MANVER3BW	MAN
كرمينية	MANVER3BW
كس	MANVER3BW
كلاب	كُلّاب,كَلْب
كلب	كَلِب,كَلَب,كَلْب,كَلِب-َ,لُبّ,كَلَّب
كنانة	كِنانَة,كُنَّة
ما ?وراء ?النهر	MANVER3BW	MAN
مذحج	MANVER3BW
مراد	مُراد,مارِد,مَراد,مَرّاد
مراغة	MANVER3BW
مرو	مَرْوَة,مَرْو
مرو ?الروذ	MANVER3BW
مصر	مِصْر,مُصِرّ
معدن	مُعَدِّن,مَعَد-َ,مَعْدَن,مَعْدِن
مكة	MANVER3BW	MAN
مكران	مَكَرّ
ملل	مِلَّة,مُلَّة,مَلَل
منبج	MANVER3BW
منى	مُنَى,مَنَى-ِ,مَنّ,مِنَى,مِن,مَنَى,مَنَّى
مهرة	مَهْر,مُهْرَة,مُهْر,ماهِر
ميافارقين	MANVER3BW
نابلس	MANVER3BW	MAN
نجد	وَجَد-ِ,أَجْدَى,جَدا,نَجَد,نَجِد-َ,نَجْد,أَجَدّ,جاد,نَجَّد,أَجاد,جَدّ-ِ
نجران	MANVER3BW	MAN
نخلة	نَخْلَة,نَخَل,أَخْلَى,خَلّ,خَلا,خال-َ,نَخْل,أَخَلّ,خَلَّى
نسا	MANVER3BW
نسف	نَسْف,سَفَى-ِ,أَسْفَى,نَسَف-ِ,أَسَفّ
نصيبين	MANVER3BW	MAN
نهاوند	MANVER3BW
نهر الملك	مَلِك,مِلْك,مُلْك
نيسابور	MANVER3BW
هجر	هَجَر,هَجَّر,هَجْر
هراة	MANVER3BW	MAN
همذان	MANVER3BW
همدان	MANVER3BW
هيت	هَيَّت,هَيْتَ,هِيت
وادي القرى	MANVER3BW	MAN
واسط	سَطا,ساط
يزد	زاد-ِ,أَزاد
ينبع	ٱِنْباع,أَنْبَع,يَنْبُع,نَبَع-َُِ