اب	أب,آب,أَبّ,أَب,إِبّ
ابا	أَبا,آب,أَبّ,أَب
اباتر	NEWMORPH
ابار	أَبار,بارَى,بِئْر
اباض	أُبْض
اباغ	NEWMORPH
ابام	NEWMORPH
ابان	أَبان,إِبّان
ابانان	NEWMORPH
ابة	آبِه,آب,أَبَه,أَبَه-َِ,أَبّ,بَهِي-َ
ابتر	أَبْتَر,بَتَر
ابترة	أَبْتَر,بَتَر
ابثيت	NEWMORPH
ابج	NEWMORPH
ابجيج	NEWMORPH
ابخاز	NEWMORPH
ابدة	أَباد,أَبَد-ِ,أَبْدَى,بَدا,أَبَّد,باد-ِ,آبِد,أَبَد,بَدَه-َ,بَدّ,آبِدَة
ابذغ	NEWMORPH
ابر	بَرّ-ِ,أَبَرّ,بَرَى-ِ,إِبْرَة,أَبار,أَبَّر,بار,أَبَر-ُِ
ابراد	بُرْد
ابراص	NEWMORPH
ابراق	NEWMORPH
ابرشتويم	NEWMORPH
ابرشهر	NEWMORPH
ابرقوه	أَبْرَق
ابرم	بَرِم-َ,أَبْرَم,بَرَّم,بَرَم
ابروقا	NEWMORPH
ابرين	NEWMORPH
ابرينق	NEWMORPH
ابزار	بِزْر
ابزقباذ	NEWMORPH
ابسس	بَسّ
ابسكون	NEWMORPH
ابسوج	NEWMORPH
ابشاي	NEWMORPH
ابشويه	NEWMORPH
ابشية	NEWMORPH
ابشيش	NEWMORPH
ابضع	أَبْضَع,بَضَّع,بَضَع-َ
ابغر	بَغَر
ابكن	آب,أَبّ
ابل	بَلّ-ِ,بَلّ,إِبْل,بَلا,أَبال,بال,بَلِي-َ,أَبَلّ,وَبَل-ِ,أَبْلَى
ابلستين	NEWMORPH
ابلى	إِبْل,بَلا,إِبْلِيّ,بَلِي-َ,أَبْلَى
ابلي	إِبْل,بَلا,إِبْلِيّ,بَلِي-َ,أَبْلَى
ابليل	NEWMORPH
ابنبم	NEWMORPH
ابند	بَنَّد
ابندون	NEWMORPH
ابنود	NEWMORPH
ابنى	آب,ٱِبْن,بَنَى-ِ,أَبان,أَبّ
ابه	آب,بَهِي-َ,آبِه,أَبَه,أَبَه-َِ,أَبّ
ابهر	بَهَر-َ,أَبْهَر
ابوان	أَب
ابوى	أَب,أَبَوِيّ
ابويط	NEWMORPH
ابيار	NEWMORPH
ابيان	أَبِيّ,آبِي
ابيدة	أَباد,باد-ِ
ابير	أَبار
ابيط	NEWMORPH
ابيم	NEWMORPH
ابين	أَبْيَن,أَبان,بَيَّن,آبِي,أَبَى-َ,بان-ِ
ابيورد	NEWMORPH
ابيوهة	NEWMORPH
اتريب	تَرَيَّب
اتريش	تَرَيَّش
اتشند	NEWMORPH
اتفيح	NEWMORPH
اتكو	NEWMORPH
اتل	أَتْلَى,تَلا
اتيدة	NEWMORPH
اتيل	تَيَّل
اثافت	NEWMORPH
اثال	NEWMORPH
اثامد	NEWMORPH
اثاية	NEWMORPH
اثبيت	NEWMORPH
اثرب	ثَرَّب,ثَرَب-ِ
اثليدم	NEWMORPH
اثمد	إِثْمِد
اثنان	ٱِثْنانِ
اثوا	أَثّ-َُِ
اثور	ثار,ثَوَّر
اثول	أُثُول,أَثْل
اثيدة	NEWMORPH
اثير	أَثِير,أَثار
اثيفيات	NEWMORPH
اثيفية	NEWMORPH
اثيل	أَثِيل
اجا	أَجّ
اجارد	NEWMORPH
اجان	جانَى
اجدابية	NEWMORPH
اجداد	جَدّ
اجدث	NEWMORPH
اجذال	جِذْل
اجر	آجَر,جار,أَجَر,أَجار,أَجَّر,أُجْرَة,أَجْر,أَجْرَى,جَرَى-ِ,أَجَرّ,جَرّ
اجراد	NEWMORPH
اجراف	NEWMORPH
اجرب	أَجْرَب,جَرَّب,جَرِب-َ
اجزل	أَجْزَل,جَزُل
اجش	أَجَشّ,جاش-ِ,جَشّ
اجشد	NEWMORPH
اجلة	آجِلَة,أَجْل,أَجَّل,جَلا,أَجْلَى,جَلَى-ِ,جال,آجِل,جَلَّى,أَجال,أَجَلّ,أَجَل
اجلى	أَجْل,جَلا,أَجْلَى,جَلَى-ِ,آجِل,جَلَّى,أَجَلّ,أَجَل
اجم	جَمّ-ُِ,وَجَم-ِ,أَجَمَة
اجنادين	NEWMORPH
اجنقان	NEWMORPH
اجول	جال,جَوَّل
اجوية	NEWMORPH
اجياد	جَواد
اجيرة	أَجار,جَيَّر,أَجِير,أَجِيرَة
احارب	حارَب
احامرة	NEWMORPH
احباب	حَبِيب
احثال	NEWMORPH
احد	أَحَد,أَحَّد,حَدِي,حاد-ِ,حاد,أَحَدّ,حَدّ-ِ,حَدّ,حَدا
احدث	حَدَث,أَحْدَث
احراد	NEWMORPH
احراص	NEWMORPH
احراض	NEWMORPH
احرض	حَرَض-ِ,حَرَّض
احزاب	حِزْب
احلى	أَحْلَى,حَلَى,حَلَّى,حَلِي-َ,حَلُو
احليل	إِحْلِيل
احليلاء	NEWMORPH
احليلي	إِحْلِيل
احمداباذ	NEWMORPH
احوس	NEWMORPH
اخا	أَخ
اخثال	NEWMORPH
اخر	خار-ِ,آخِر,خَرّ-ُِ,خار,آخَر
اخرب	أَخْرَب,خَرِب-َ,خَرَب-ِ,خَرَّب
اخرم	خَرَم-ِ,خَرَّم
اخزم	خَزَم-ِ
اخسيسك	NEWMORPH
اخسيكث	NEWMORPH
اخشنبة	NEWMORPH
اخطب	خَطَب
اخطبة	خَطَب,خِطاب
اخلاء	إِخْلاء,خَلِيل
اخميم	NEWMORPH
اخنا	أَخَنّ,وَخَى-ِ
اخناث	NEWMORPH
ادام	أَدام,إِدام,أَدّام
ادامى	إِدام,أَدّام
ادبي	آدِب,أَدَب,أَدَبِيّ,أَدْب
ادرفركال	NEWMORPH
ادرنت	أَدْرَن
ادرنكة	NEWMORPH
ادريت	أَدْرَى
ادريجة	NEWMORPH
ادفة	داف,دَفّ-ِ
ادفو	NEWMORPH
ادقية	أَدَقّ
ادم	دَمّ,أَدام,آدَم,دام,دَمِي-َ,دَمَّى,أَدْمَى
ادماء	NEWMORPH
ادماث	NEWMORPH
ادمام	NEWMORPH
ادمان	إِدْمان
ادمى	دَمِي-َ,دَمَّى,آدَمِيّ,أَدْمَى
اديات	NEWMORPH
اديم	أَدام,أَدِيم
اديمة	أَدام,أَدِيم
اذاخر	NEWMORPH
اذاسا	NEWMORPH
اذافر	NEWMORPH
اذبل	ذَبَل
اذربيجان	أَذَرْبَيْجان
اذرح	NEWMORPH
اذرع	ذِراع,ذَرَع-َ
اذرعات	NEWMORPH
اذرم	NEWMORPH
اذرمة	NEWMORPH
اذكان	NEWMORPH
اذلق	أَذْلَق
اذن	أَذِن-َ,أَذَّن,آذِن,إِذْن,أُذُن,إِذَن,آذَن,شَنّ
اذنة	أَذِن-َ,أَذَّن,إِذْن,آذِن,أُذُن,آذَن
اذون	إِذْن
اذينة	أَذِي-َ,أُذَيْنَة,آذَى,أُذَيْن
اذيوخان	NEWMORPH
اراب	آراب,رابَى,إِرْب,أَراب
ارابن	NEWMORPH
ارار	NEWMORPH
اراش	NEWMORPH
اراط	NEWMORPH
اراطة	NEWMORPH
اراطى	NEWMORPH
اراظ	NEWMORPH
اراق	أَراق,أُراق
اراك	رَأَى-َ
ارال	NEWMORPH
اران	NEWMORPH
ارانب	أَرْنَب
ارباع	رُبْع
اربة	أَرَب,أَرَب-ِ,راب-ِ,آرَب,راب,أَرِب,أُرْب,أَراب,إِرْب,أَرْبَى,رَبا,رَبَّى
اربد	ٱِرْبَدّ,إِرْبِد
اربق	NEWMORPH
اربك	أَرَب,رَبَك,أَرَب-ِ,راب-ِ,آرَب,راب,أَرْبَك,أَرِب,رَبِك-َ,أُرْب,إِرْب,أَراب,أَرْبَى,رَبا,رَبَّى
اربل	NEWMORPH
اربنجن	NEWMORPH
اربونة	NEWMORPH
اربيخ	NEWMORPH
ارة	رَها,وَرَى-ِ,رَأَى-َ,آر
ارتاح	ٱِرْتاح
ارتامة	NEWMORPH
ارتل	رَتَّل,رَتِل-َ
ارتيان	NEWMORPH
ارثخشميثن	NEWMORPH
ارثد	NEWMORPH
ارجان	أَرِج
ارجذونة	NEWMORPH
ارجكوك	NEWMORPH
ارجنوس	NEWMORPH
ارجونة	أَرْجُون
ارجيش	NEWMORPH
ارحب	رَحُب,رَحَّب,رَحِب-َ
ارخس	NEWMORPH
ارخمان	NEWMORPH
ارد	رَدِي-َ,راد,رَدَّى,أَرَدّ,رَدّ,أَرْدَى,أَراد,وَرَد-ِ
اردبيل	أَرْدَبِيل
اردستان	NEWMORPH
اردشاط	NEWMORPH
اردشيرخره	NEWMORPH
اردمشت	NEWMORPH
اردهن	رَدِي-َ,راد,رَدَّى,أَرَدّ,أَراد,أَرْدَى,رَدّ,وَرَد-ِ
اردوال	NEWMORPH
ارز	أَرَزّ,رَزّ,رُزّ,راز,أَرْز
ارزكان	NEWMORPH
ارزن	رَزُن
ارزنان	NEWMORPH
ارزنجان	NEWMORPH
ارزنقاباذ	NEWMORPH
ارزونا	أَرَزّ
ارس	رَسا,رَسَّى,أَرْسَى,أَرَس-ِ
ارسابند	NEWMORPH
ارسناس	NEWMORPH
ارسوف	NEWMORPH
ارشذونة	NEWMORPH
ارشق	رَشُق,رَشَق
ارضيط	NEWMORPH
ارطاة	NEWMORPH
ارعب	رَعَب-َ,رَعَّب,أَرْعَب
ارعنز	NEWMORPH
ارغيان	NEWMORPH
ارفاد	رِفْد
ارقانيا	NEWMORPH
ارقنين	NEWMORPH
ارك	وَرَى-ِ,رَأَى-َ,آر,رَكّ,رَكّ-ِ
اركان	رُكْن,إِرْكان
اركو	NEWMORPH
اركون	NEWMORPH
ارل	رال-ِ
ارم	رَمّ-ِ,رام-ِ,وَرِم-ِ,رَمَى-ِ,أُرَّم,إِرَم,رَمّ,أَرَم-ِ,أَرَّم,رام
ارماث	رَمَث
ارمام	NEWMORPH
ارمائيل	NEWMORPH
ارملول	NEWMORPH
ارمناز	NEWMORPH
ارمنت	NEWMORPH
ارمى	رَمَى-ِ,أُرَّم,إِرَم
ارمي	رَمَى-ِ,أُرَّم,إِرَم
ارمية	رَمَى-ِ,إِرَم
ارميم	NEWMORPH
ارمينية	NEWMORPH
ارمئيل	NEWMORPH
ارن	رَنّ-ِ,رَنا,ران-ِ,رَنَّى,أَرْنَى
ارنبويه	NEWMORPH
ارنم	رَنَّم
ارنيش	NEWMORPH
ارنيط	NEWMORPH
ارهن	وَرَى-ِ,رَهَن-َ,رَأَى-َ,آر,أَرْهَن
ارواد	NEWMORPH
اروان	NEWMORPH
اروخ	NEWMORPH
اروك	أَرْوَى,رَوَى-ِ,رَوَّى
ارول	رَوَّل
اروم	رام
ارون	أَرُون
اروند	NEWMORPH
اروى	أَرْوَى,رَوَى-ِ,رَوَّى
ارياب	NEWMORPH
اريح	رَيَّح,أَراح
اريحا	أَرِيحا
اريض	أَرِيض
اريك	وَرَى-ِ,أَري,آرِيّ,أَرِيكَة
اريكة	أَرِيكَة
اريلية	NEWMORPH
اريم	رام-ِ,رَيَّم
ارينبات	NEWMORPH
ارينبة	NEWMORPH
ارينة	ران-ِ
اريوجان	NEWMORPH
اريول	NEWMORPH
ازاب	NEWMORPH
ازادمرداباذ	NEWMORPH
ازاذان	NEWMORPH
ازاذوار	NEWMORPH
ازال	أَزال,زال-َ,أَزَل
ازبد	أَزْبَد,زَبَد,زَبَّد
ازة	زُهِي-َ,أَزْهَى,زَها,أَزّ
ازجاه	أَزَجّ,أَزَج,أَزْجَى
ازر	أَزار,وَزَر-ِ,زَرَى-ِ,أَزْر,أَزَّر,آزَر,أَزَر-ِ,زَرّ,زار,إِزار,أَزْرَى
ازرميدخت	NEWMORPH
ازقبان	NEWMORPH
ازم	أَزَّم,زام,أَزْمَة,آزِم,زَمّ
ازمورة	NEWMORPH
ازن	وَزَن-ِ,زان-ِ,زَنّ,زَنَى-ِ
ازناو	NEWMORPH
ازنري	NEWMORPH
ازنم	NEWMORPH
ازنيك	زَنَى-ِ
ازوارة	NEWMORPH
ازيلي	NEWMORPH
ازيهر	NEWMORPH
اساف	NEWMORPH
اسال	أَسال
اسالة	أَسالَة,أَسال
اسالم	سالَم
اسانير	NEWMORPH
اساهم	أُسّ,آسَى,آس,أَسَى,ساهَم,أَسا,أَسَّى
اساود	NEWMORPH
اسبار	NEWMORPH
اسبانبر	NEWMORPH
اسبانيكث	NEWMORPH
اسبذ	NEWMORPH
اسبسكث	NEWMORPH
اسبهبذ	NEWMORPH
اسبيذرود	NEWMORPH
اسبيذهان	NEWMORPH
اسبيرن	NEWMORPH
اسبيل	NEWMORPH
استا	آسَى,ٱِسْت,أَسا,أَسَّى
استاذبران	NEWMORPH
استاذخرذ	NEWMORPH
استارقين	NEWMORPH
استانة	إِسْتانَة
استجة	NEWMORPH
استراباذ	NEWMORPH
استرسن	NEWMORPH
استغداديزة	NEWMORPH
استناباذ	NEWMORPH
استوا	NEWMORPH
استوريس	NEWMORPH
استوناوند	NEWMORPH
استيا	ٱِسْتِيّ
استينيا	NEWMORPH
اسحمان	أَسْحَم
اسداباذ	NEWMORPH
اسر	أُسْرَة,أَسَر-ِ,سَرَى-ِ,سَرَّى,سار-ِ,أَسَرّ,أَسار,سَرّ,أُسْر,أَسْرَى,أَسْر
اسروشنة	NEWMORPH
اسطان	NEWMORPH
اسطوان	أُسْطَى
اسطوخوذوس	NEWMORPH
اسف	آسَف,سَفَى-ِ,أَسَف,أَسْفَى,آسِف,أَسَفّ,أَسِف-َ
اسفاقس	NEWMORPH
اسفانبر	NEWMORPH
اسفجين	NEWMORPH
اسفذن	NEWMORPH
اسفرايين	NEWMORPH
اسفرنج	NEWMORPH
اسفزار	NEWMORPH
اسفس	NEWMORPH
اسفنج	إِسْفَنْج
اسفونا	آسَف,أَسْفَى,آسِف,أَسَفّ
اسفي	سَفَى-ِ,أَسَف,أَسْفَى,آسِف
اسفيجاب	NEWMORPH
اسفيذ	NEWMORPH
اسفيذار	NEWMORPH
اسفيذاسنج	NEWMORPH
اسفيذبان	NEWMORPH
اسفيذجان	NEWMORPH
اسفيذدشت	NEWMORPH
اسفيذروذبار	NEWMORPH
اسفيذن	NEWMORPH
اسفيرة	NEWMORPH
اسفينقان	NEWMORPH
اسقب	NEWMORPH
اسقف	سَقْف,سَقَّف,أُسْقُف
اسقفة	سَقْف,سَقَّف,أُسْقُف
اسك	أُسّ,آس,سَكّ-َ,سَكّ,أَسَكّ,ساك
اسكارن	NEWMORPH
اسكاف	إِسْكاف
اسكبون	NEWMORPH
اسكر	أَسْكَر,سَكِر-َ,سَكَّر
اسكلكند	NEWMORPH
اسكندرونة	إِسْكَنْدَرُونَة
اسكونيا	NEWMORPH
اسكيغفن	NEWMORPH
اسلام	إِسْلام
اسلمان	أَسْلَم
اسمند	NEWMORPH
اسميثن	NEWMORPH
اسن	سَنَّى,سَنا,آسِن,أَسِن-َ,أَسَنّ,سَنّ
اسنا	أُسّ,آس,آسِن,أَسِن-َ,أَسَنّ
اسناف	NEWMORPH
اسنان	سِنّ,آسِن,أَسَنّ
اسنمة	سَنام
اسوارية	إِسْوار
اسوان	أَسْوان
اسيا	أَسْيا,آسِي,آسَى,أَسِي-َ,أُسِّيّ,أَسَّى
اسيس	NEWMORPH
اسيلة	سَيَّل,أَسِيل,سال-ِ,أَسال
اسيوت	NEWMORPH
اسيوط	أَسْيُوط
اش	وَشَى-ِ
اشابة	أَشاب,أُشابَة,شابَه
اشاقر	NEWMORPH
اشاهم	NEWMORPH
اشب	شَبّ-ِ,شَبّ,أَشاب,أَشَّب,أَشَب,أَشِب-َ,شاب,شاب-ِ
اشبورة	NEWMORPH
اشبيلية	إِشْبِيلِيَّة,إِشْبِيلِيّ
اشتابديزة	NEWMORPH
اشتاخوست	NEWMORPH
اشتر	ٱِشْتَرَى,شَتَر-ِ
اشترج	NEWMORPH
اشتون	NEWMORPH
اشتيخن	NEWMORPH
اشداخ	NEWMORPH
اشروسنة	NEWMORPH
اشطاط	NEWMORPH
اشفند	NEWMORPH
اشقاب	NEWMORPH
اشقالية	NEWMORPH
اشقة	شَقّ,شَقا,شَقِي,أَشْقَى,شاق,شَقِيق
اشقر	أَشْقَر,شَقِر-َ,ٱِشْقَرّ
اشقوبل	NEWMORPH
اشكابس	NEWMORPH
اشكر	شَكَر
اشكرب	NEWMORPH
اشكنوار	NEWMORPH
اشكوران	NEWMORPH
اشكونية	NEWMORPH
اشكيذبان	NEWMORPH
اشكيشان	NEWMORPH
اشليم	NEWMORPH
اشمذان	NEWMORPH
اشمنت	NEWMORPH
اشموم	NEWMORPH
اشمون	NEWMORPH
اشمونيث	NEWMORPH
اشميون	NEWMORPH
اشناذجرد	NEWMORPH
اشنانبرت	NEWMORPH
اشند	NEWMORPH
اشنه	أُشْنَة,أَشَنّ,شان-ِ,شَنّ
اشنين	NEWMORPH
اشوقة	شَوَّق,شاق
اشونة	شَوَّن
اشي	وَشَى-ِ
اشيح	أَشاح,شَيَّح
اشير	أَشار
اشيقر	NEWMORPH
اصبع	صَبَع-َ,إِصْبَع
اصبغ	صَبَغ
اصبهان	NEWMORPH
اصبهانات	NEWMORPH
اصبهانك	NEWMORPH
اصبهبذان	NEWMORPH
اصطاذنة	NEWMORPH
اصطخر	NEWMORPH
اصطفانوس	NEWMORPH
اصطنبول	NEWMORPH
اصفون	NEWMORPH
اصم	أَصْمَى,صَمّ,وَصَم-ِ,صام,أَصَمّ
اصمت	أَصْمَى,أَصْمَت,صَمَت,أَصَمّ,صَمَّت
اصيل	أَصِيل
اضاخ	NEWMORPH
اضان	NEWMORPH
اضبع	ضَبْع
اضراس	ضِرْس
اضرعة	ضَرَع
اضم	ضام-ِ,ضَمّ
اضوح	NEWMORPH
اطان	NEWMORPH
اطايف	NEWMORPH
اطحل	NEWMORPH
اطد	وَطَد-ِ
اطرابزندة	NEWMORPH
اطرابلس	NEWMORPH
اطرابنش	NEWMORPH
اطرار	NEWMORPH
اطراف	طَرَف
اطرب	أَطْرَب,طَرِب-َ,طَرَّب
اطرقا	أَطْرَق
اطرون	NEWMORPH
اطسا	NEWMORPH
اطفيح	NEWMORPH
اطلاح	NEWMORPH
اطلحاء	NEWMORPH
اطهار	طاهِر
اطواء	طَيّ
اطواب	NEWMORPH
اطيط	أَطِيط
اظايف	NEWMORPH
اظفار	ظُفُر
اظلم	ٱِظَّلَم,أَظْلَم,ظَلَم-َِ
اعابل	NEWMORPH
اعامق	NEWMORPH
اعشار	عُشْر
اعظام	NEWMORPH
اعفر	أَعْفَر,عَفَر-ِ,عَفَّر
اعكش	عَكَش-ِ
اعلاب	NEWMORPH
اعناز	NEWMORPH
اعناك	أَعان
اعواء	NEWMORPH
اعوص	أَعْوَص,عَوِص-َ
اعيار	عَيْر,عار
اعيب	عاب-ِ,عَيَّب
اعيرض	NEWMORPH
اعين	أَعان,عَيَّن,عَيْن
اغذون	NEWMORPH
اغزون	NEWMORPH
اغمات	NEWMORPH
اغناق	NEWMORPH
اغواث	NEWMORPH
افاحيص	أُفْحُوص
افاز	NEWMORPH
افاعية	أَفْعَى
افاق	أَفاق,أُفُق,أَفّاق
افامية	NEWMORPH
افر	فَرَّى,وَفَر-ِ,أَفْرَى,فَرَى-ِ,أَفَرّ,فار,أَفار,فَرّ-ِ
افراغة	إِفْراغ
افران	فُرْن
افرخش	NEWMORPH
افرع	فَرَّع,أَفْرَع
افرندين	NEWMORPH
افريقية	أَفْرِيقِيّ
افسوس	NEWMORPH
افشنة	NEWMORPH
افشوان	NEWMORPH
افشيرقان	NEWMORPH
افكان	إِفْك
افلاطنس	NEWMORPH
افلوغونيا	NEWMORPH
افليج	NEWMORPH
افليلاء	NEWMORPH
افوى	NEWMORPH
افي	وَفَى-ِ,أَفِي
افيح	أَفْيَح
افيعية	NEWMORPH
افيق	أَفاق
اقتد	ٱِقْتَدَى,ٱِقْتاد,ٱِقْتَدّ
اقدام	قَدَم,إِقْدام
اقر	أَقَرّ,قَرّ-َِ,وَقَر-ِ,قَرَى-ِ,قَرا
اقرن	أَقْرَن,قَرَن-ِ
اقريطش	NEWMORPH
اقساس	NEWMORPH
اقفهس	NEWMORPH
اقلوش	NEWMORPH
اقليبية	NEWMORPH
اقليد	إِقْلِيد
اقليش	NEWMORPH
اقليم	إِقْلِيم
اقليمية	إِقْلِيمِيَّة,إِقْلِيم,إِقْلِيمِيّ
اقميناس	NEWMORPH
اقنا	آق,وَقَى-ِ
اقور	قَوَّر
اكام	أَكَمَة
اكباد	كَبِد
اكبرة	كَبَّر,كَبَر,أَكْبَر
اكتال	NEWMORPH
اكرسيف	NEWMORPH
اكسال	NEWMORPH
اكسنتلا	NEWMORPH
اكشوثاء	NEWMORPH
اكشونية	NEWMORPH
اكل	آكِل,أَكَّل,آكَل,كال-ِ,أُكُل,أَكَلّ,أَكَل,أَكْل,وَكَل-ِ
اكلب	كَلِب-َ,كَلَّب
اكمان	NEWMORPH
اكمة	أَكَمَة,أَكْمَه,كَمّ
اكهى	NEWMORPH
اكيراح	NEWMORPH
اكيم	NEWMORPH
الاات	NEWMORPH
الاب	آب,أَب
الابار	بِئْر
الابارق	NEWMORPH
الاباصر	NEWMORPH
الابالخ	NEWMORPH
الابايض	NEWMORPH
الابر	إِبْرَة
الابراقات	NEWMORPH
الابرشية	أَبْرَشِيّ
الابرقان	NEWMORPH
الابرقة	NEWMORPH
الابروق	NEWMORPH
الابطح	أَبْطَح
الابك	NEWMORPH
الابكر	أَبْكَر,بَكْر
الابكين	NEWMORPH
الابلاء	NEWMORPH
الابلة	أَبْلَه,أُبُلَّة
الابلق	أَبْلَق
الابواء	NEWMORPH
الابواص	NEWMORPH
الابيض	أَبْيَض
الات	آلَة
الاتلاء	NEWMORPH
الاتم	أَتَمّ
الاتيم	NEWMORPH
الاثارب	NEWMORPH
الاثالث	NEWMORPH
الاثبجة	NEWMORPH
الاثبرة	NEWMORPH
الاثل	أَثْل
الاثلة	أَثْلَة
الاثوار	NEWMORPH
الاثيداء	NEWMORPH
الاثيرة	أَثِير
الاثيل	أَثِيل
الاجاءة	NEWMORPH
الاجابين	NEWMORPH
الاجام	أَجَمَة
الاجاول	NEWMORPH
الاجباب	جُبّ
الاجدلان	NEWMORPH
الاجر	أُجْرَة,أَجْر
الاجرد	أَجْرَد
الاجرعين	NEWMORPH
الاجفر	NEWMORPH
الاجيراف	NEWMORPH
الاجيفر	NEWMORPH
الاحاسب	NEWMORPH
الاحاسن	أَحْسَن
الاحث	NEWMORPH
الاحدب	أَحْدَب
الاحساء	أَحْساء
الاحسية	حَسْوَة
الاحص	NEWMORPH
الاحصبان	NEWMORPH
الاحفار	NEWMORPH
الاحقاف	NEWMORPH
الاحمدي	أَحْمَدِيّ
الاحمر	أَحْمَر
الاحواز	حَوْز
الاحواض	حَوْض
الاحياء	حَيّ,إِحْياء
الاحيدب	NEWMORPH
الاحيسى	NEWMORPH
الاخابث	NEWMORPH
الاخاديد	أُخْدُود
الاخارج	NEWMORPH
الاخاشب	NEWMORPH
الاخباب	NEWMORPH
الاخراب	NEWMORPH
الاخرج	NEWMORPH
الاخرجان	NEWMORPH
الاخرجة	NEWMORPH
الاخرجية	NEWMORPH
الاخرم	NEWMORPH
الاخروت	NEWMORPH
الاخروج	NEWMORPH
الاخشب	NEWMORPH
الاخشبان	NEWMORPH
الاخشين	NEWMORPH
الاخصاص	خُصّ
الاخضر	أَخْضَر
الاخلفة	NEWMORPH
الاخنونية	NEWMORPH
الاخيان	NEWMORPH
الاداة	أَداة
الادامي	NEWMORPH
الاداهم	NEWMORPH
الادبر	NEWMORPH
الادنيان	أَدْنَى
الادهم	أَدْهَم
الادواء	دَوَى,داء
الاراسة	NEWMORPH
الارام	رِئْم,إِرَم
الاربس	NEWMORPH
الاربعاء	أَرْبِعاء
الارتيق	NEWMORPH
الارجام	NEWMORPH
الارحاء	رَحَى
الارحضية	NEWMORPH
الارخ	NEWMORPH
الاردن	أُرْدُنّ
الارفغ	NEWMORPH
الارفود	NEWMORPH
الارند	NEWMORPH
الاريتاق	NEWMORPH
الارين	NEWMORPH
الازاج	أَزَج
الازارق	NEWMORPH
الازاغب	NEWMORPH
الازج	أَزَجّ,أَزَج
الازوران	أَزْوَر
الاساسان	أَساس
الاسكندرية	إِسْكَنْدَرِيَّة,إِسْكَنْدَرِيّ
الاسواط	سَوْط
الاسورة	سِوار
الاشاءة	NEWMORPH
الاشافي	إِشْفَى
الاشتوم	NEWMORPH
الاشعر	أَشْعَر
الاشفار	شَفْر
الاشفيان	NEWMORPH
الاشق	NEWMORPH
الاشل	أَشَلّ
الاشنان	أُشْنان
الاشيم	NEWMORPH
الاشيمان	NEWMORPH
الاصاد	NEWMORPH
الاصاغي	NEWMORPH
الاصدار	إِصْدار
الاصنام	صَنَم
الاصهبيات	NEWMORPH
الاصيهب	NEWMORPH
الاضاء	NEWMORPH
الاضارع	NEWMORPH
الاضوج	NEWMORPH
الاعارف	NEWMORPH
الاعبدة	NEWMORPH
الاعدان	NEWMORPH
الاعراض	عَرَض,إِعْراض,عِرْض
الاعراف	عُرْف
الاعزلان	أَعْزَل
الاعقة	عَقِيق
الاعلم	أَعْلَم
الاعماق	عُمْق
الاعوض	NEWMORPH
الاعيان	عَيْن
الاعيرف	NEWMORPH
الاغدرة	NEWMORPH
الاغر	أَغَرّ
الاغران	أَغَرّ
الافاعي	أَفْعَى
الافاقة	أَفّاق,إِفاقَة
الافاهيد	NEWMORPH
الافداغ	NEWMORPH
الافراحون	NEWMORPH
الافراع	NEWMORPH
الافراق	NEWMORPH
الافشولية	NEWMORPH
الافقوسية	NEWMORPH
الافلاج	فَلَج
الافهار	NEWMORPH
الاق	لاقَى
الاقاعص	NEWMORPH
الاقحوانة	NEWMORPH
الاقدحان	NEWMORPH
الاقرع	أَقْرَع
الاقصر	أَقْصَر,أُقْصُر
الاقطانتين	NEWMORPH
الاقعس	أَقْعَس
الاقفاص	قَفَص
الاقلام	قَلَم
الاقياع	NEWMORPH
الاقير	NEWMORPH
الاقيصر	NEWMORPH
الاقيلبة	NEWMORPH
الاكاحل	NEWMORPH
الاكادر	NEWMORPH
الاكام	أَكَمَة
الاكراد	كُرْدِيّ
الاكناف	كَنَف
الاكواخ	كُوخ
الاكوار	كُور
الاكوام	كَوْم
الال	آل
الالاهة	إِلاه,إِلٰه
الالة	إِلٰه,آلَة
الاليل	NEWMORPH
الاماحل	NEWMORPH
الامالح	NEWMORPH
الامثال	مِثْل,مَثَل
الامراء	أَمِير
الامراج	NEWMORPH
الامرار	مُرّ,إِمْرار
الامرغ	NEWMORPH
الاملاح	مِلْح,مَلِيح
الاملال	NEWMORPH
الاملحان	أَمْلَح
الاملول	NEWMORPH
الامهاد	NEWMORPH
الاميرية	أَمِيرِيّ
الاميشط	NEWMORPH
الاميلح	NEWMORPH
الاميلحان	NEWMORPH
الامين	أَمِين
الاميوط	NEWMORPH
الانبار	أَنْبار,نِبْر
الاندلس	أَنْدَلُس
الانسر	NEWMORPH
الانعم	أَنْعَم,نِعْمَة
الانعمان	أَنْعَم
الانقور	NEWMORPH
الانكبردة	NEWMORPH
الانواص	NEWMORPH
الانواط	نَوْط
الانيس	أَنِيس
الانيعم	NEWMORPH
الاهرام	هَرَم
الاهمول	NEWMORPH
الاهواز	أَهْواز
الاهيل	NEWMORPH
الاوار	أُوار
الاواشح	NEWMORPH
الاوانة	NEWMORPH
الاوداء	NEWMORPH
الاودات	NEWMORPH
الاودية	وادِي
الاوزاع	أَوْزاع
الاوسج	NEWMORPH
الاوسية	NEWMORPH
الاوطاس	NEWMORPH
الاوعار	وَعْر
الاولاج	NEWMORPH
الاياد	NEWMORPH
الايال	NEWMORPH
الايسر	أَيْسَر
الايسن	NEWMORPH
الايغاران	NEWMORPH
الايكة	أَيْكَة
الايم	أَيِّم
الايواز	NEWMORPH
الايوان	إِيوان
الباب	لَبَب,باب,لُبّ
البابة	بابِه,لَبَب,لُبّ
الباج	NEWMORPH
البادية	بادِيَة,بادِي
الباذنجانية	NEWMORPH
البارة	بارّ
الباسرة	NEWMORPH
الباقرة	NEWMORPH
البالدية	NEWMORPH
البان	أَلْبانِيّ,لَبَن
البت	بَتّ,أَلَب,أَلَّب
البتراء	أَبْتَر,بِتْراء
البتم	أَلَب,أَلَّب
البثاء	NEWMORPH
البثر	بَثْر,بَثِر
البثراء	NEWMORPH
البثنة	NEWMORPH
البثنون	NEWMORPH
البثنية	NEWMORPH
البجادة	NEWMORPH
البجرات	NEWMORPH
البجسة	NEWMORPH
البجوم	بَجْم
البحرة	بَحْرَة
البحرين	بَحْرَيْنِ,بَحْر
البحيرة	بُحَيْرَة
البخارية	بُخارِيّ
البخراء	NEWMORPH
البدائع	بَدِيعَة
البدي	NEWMORPH
البدية	NEWMORPH
البديعة	بَدِيعَة
البذان	NEWMORPH
البذرمان	NEWMORPH
البرابي	بِرْبَة
البرادان	بَرّاد
البرامكة	NEWMORPH
البراهق	NEWMORPH
البربر	بَرْبَرِيّ
البرة	NEWMORPH
البرتان	NEWMORPH
البرج	بُرْج
البرجلانية	NEWMORPH
البردان	NEWMORPH
البرزمان	NEWMORPH
البرشلية	NEWMORPH
البرقاء	NEWMORPH
البرقانية	NEWMORPH
البرقعة	NEWMORPH
البرك	بِرْكَة
البرود	بُرُود,بَرُود
البروية	NEWMORPH
البريت	NEWMORPH
البريد	بَرِيد
البريدن	NEWMORPH
البريراء	NEWMORPH
البريص	NEWMORPH
البريقان	إِبْرِيق,بَرِيق
البريقة	NEWMORPH
البريكان	NEWMORPH
البز	بُزّ,بَزّ
البزاز	بُزّ,بَزّاز
البزواء	NEWMORPH
البسراط	NEWMORPH
البسرة	بُسْر
البسكت	NEWMORPH
البسيطة	بَسِيط,بَسِيطَة
البشر	بُشْر,بِشْر,بَشَر
البشرود	NEWMORPH
البشمور	NEWMORPH
البصر	بَصَر
البصرة	بَصْرَة
البصل	بَصَل
البصلية	بَصَلِيّ
البضيض	بَضِيض
البضيع	NEWMORPH
البطاح	أَبْطَح
البطانة	بَطانَة
البطائح	بَطِيحَة
البطحاء	أَبْطَح
البطيحة	بَطِيحَة
البعوضة	بَعُوض
البقال	بَقّال
البكرات	بَكْرَة
البكرة	بُكْرَة,بَكْرَة
البكرن	NEWMORPH
البلاثق	NEWMORPH
البلاط	بَلاط,بَلاطَة
البلقاء	أَبْلَق
البلمون	NEWMORPH
البلوط	بَلُّوط
البلياء	NEWMORPH
البليح	NEWMORPH
البليخ	NEWMORPH
البليين	NEWMORPH
البنتان	بِنْت
البندنيجين	NEWMORPH
البنية	بِنْيَة
البهنسا	NEWMORPH
البوازيج	NEWMORPH
البوباة	NEWMORPH
البويب	NEWMORPH
البويرة	بُوَيْرَة
البوين	NEWMORPH
البياض	بَياض
البياو	NEWMORPH
البيداء	بَيْداء
البير	أَلْبِير
البئر	بِئْر
البيرة	بِيرَة,بِيرا
البيضاء	أَبْيَض
البيضة	بَيْضَة,بَيْض
البيضتان	بَيْض
البين	بَيْنَ,بَيِّن
البينة	بَيِّنَة
البيوان	NEWMORPH
البييضة	بُوَيْض
التاج	تاج
التاجية	تاجِيّ
التاية	NEWMORPH
التبر	تِبْر
الترب	تُرْبَة,تِرْب,تَرِب
الترجمانية	NEWMORPH
التروية	تَرْوِيَة
الترويح	تَرْوِيح
التستريون	NEWMORPH
التسرير	NEWMORPH
التعانيق	NEWMORPH
التفرق	تَفَرُّق
التقي	ٱِلْتَقَى,تُقَى,تَقِيّ
التلاعة	NEWMORPH
التلبع	NEWMORPH
التلمص	NEWMORPH
التلي	NEWMORPH
التليان	NEWMORPH
التماني	آل,ٱِلْتَمّ
التناضب	NEWMORPH
التنانير	تَنُّور
التناهي	NEWMORPH
التنعيم	تَنْعِيم
التنن	NEWMORPH
التنور	تَنُّور
التو	تَوّ,ٱِلْتَوَى
التوائم	تَوْأَم
التويرة	NEWMORPH
التويمة	NEWMORPH
التى	آلَة,الَّذِي
التيس	تَيْس
التيمرة	NEWMORPH
التيه	تِيه,آلَة
الثاملية	NEWMORPH
الثاي	NEWMORPH
الثباج	NEWMORPH
الثبراء	NEWMORPH
الثتانة	NEWMORPH
الثدي	ثَدْي
الثرب	NEWMORPH
الثربان	NEWMORPH
الثرثار	ثَرْثار
الثرثوز	NEWMORPH
الثرماء	NEWMORPH
الثرملية	NEWMORPH
الثريا	ثُرَيّا
الثعلبية	ثَعْلَبِيّ
الثغر	ثُغْرَة,ثَغْر
الثغور	ثَغْر
الثغيد	NEWMORPH
الثقب	ثَقْب,ثُقْبَة,ثُقْب
الثلاثاء	ثُلاثاء
الثلبوت	NEWMORPH
الثلم	ثَلْم,ثُلْمَة
الثلماء	NEWMORPH
الثمامة	ثُمام
الثمد	NEWMORPH
الثمراء	NEWMORPH
الثميد	NEWMORPH
الثمينة	ثَمِين
الثني	ثَنْي,لاث,ثِنْي
الثومة	ثُوم
الثوية	NEWMORPH
الثوير	NEWMORPH
الثيلة	NEWMORPH
الجاب	NEWMORPH
الجابتان	NEWMORPH
الجابري	جابِرِيّ
الجابية	جابِي,جابِيَة
الجار	جار
الجال	NEWMORPH
الجالية	جالِيَة
الجام	جام
الجامدة	جامِد
الجامع	جامِع
الجامعين	جامِع
الجاهلي	جاهِلِيّ
الجايرية	NEWMORPH
الجب	جُبّ
الجباب	جُبّ,جُبَّة
الجبابات	NEWMORPH
الجبابة	NEWMORPH
الجبابين	NEWMORPH
الجباة	جابِي,جَبْهَة
الجباجب	NEWMORPH
الجباجية	NEWMORPH
الجبال	جَبَل
الجباية	جِبايَة
الجبة	جُبَّة
الجبجبان	NEWMORPH
الجبحة	NEWMORPH
الجبل	جَبَل
الجبول	NEWMORPH
الجبيب	NEWMORPH
الجبيل	جُبَيْل
الجبيلة	NEWMORPH
الجثا	NEWMORPH
الجثجاثة	NEWMORPH
الجحفة	NEWMORPH
الجخراء	NEWMORPH
الجد	جَدّ,جِدّ
الجداة	NEWMORPH
الجداجد	جُدْجُد
الجدار	جِدار
الجدان	جَدّ
الجدائر	NEWMORPH
الجدف	NEWMORPH
الجديد	جَدِيد
الجديدة	جَدِيد
الجديف	NEWMORPH
الجذاة	NEWMORPH
الجر	جَرّ
الجرادة	جَراد
الجرادي	NEWMORPH
الجرارة	جَرّار
الجرباء	أَجْرَب
الجربتان	جَرِب
الجرجانية	NEWMORPH
الجرجومة	NEWMORPH
الجرد	جَرِد,جَرْد
الجردة	NEWMORPH
الجرع	NEWMORPH
الجرعة	جُرْعَة
الجرف	جُرْف,جَرْف
الجرفة	NEWMORPH
الجرولة	NEWMORPH
الجروي	NEWMORPH
الجريب	جَرِيب
الجريرة	جَرِيرَة
الجريسات	NEWMORPH
الجريسي	NEWMORPH
الجزائر	جَزائِر
الجزر	جَزْر,جَزِيرَة,جَزَر
الجزيرة	جَزِيرَة
الجزيز	NEWMORPH
الجسر	جِسْر
الجسرة	جَسْرَة
الجعرانة	NEWMORPH
الجعفري	جَعْفَرِيّ
الجعفرية	NEWMORPH
الجعموسة	NEWMORPH
الجفار	NEWMORPH
الجفر	جَفْر,جُفْرَة
الجفران	NEWMORPH
الجفرة	جُفْرَة
الجفرتان	جُفْرَة
الجفير	NEWMORPH
الجل	جَلّ,جُلّ
الجلاميد	جُلْمُود
الجلانية	NEWMORPH
الجلجاء	NEWMORPH
الجلس	NEWMORPH
الجلسد	NEWMORPH
الجلعب	NEWMORPH
الجلل	جَلَل,جُلَّى
الجلهمتان	NEWMORPH
الجليل	جَلِيل
الجماء	NEWMORPH
الجماجم	جُمْجُمَة
الجماح	جِماح
الجماهرية	NEWMORPH
الجمح	NEWMORPH
الجمحة	NEWMORPH
الجمد	جَمْد
الجمرة	جَمْر
الجمن	أَلْجَم
الجمهور	جُمْهُور
الجموم	NEWMORPH
الجمومان	NEWMORPH
الجميش	NEWMORPH
الجميعى	NEWMORPH
الجناب	جَناب
الجناح	جُناح,جَناح
الجنادل	جَنْدَل
الجند	جُنْد
الجنزرة	NEWMORPH
الجنوب	جَنُوب
الجنوقة	NEWMORPH
الجنيد	NEWMORPH
الجنينة	جُنَيْنَة
الجهضمية	NEWMORPH
الجو	جَوّ
الجوءة	NEWMORPH
الجواء	جَوّ
الجوابة	NEWMORPH
الجوار	جِوار
الجوانب	جانِب
الجوانية	جُوّانِيّ,جُوّانِيَّة
الجوة	NEWMORPH
الجود	NEWMORPH
الجودي	NEWMORPH
الجوز	جَوْز
الجوزقان	NEWMORPH
الجوسق	جَوْسَق
الجوشنية	NEWMORPH
الجوف	جَوْف,أَجْوَف
الجوفاء	أَجْوَف
الجولان	جَوْلان,جَوَلان
الجومة	NEWMORPH
الجوونان	NEWMORPH
الجوي	جَوَى,جَوِّيّ
الجويث	NEWMORPH
الجيار	جَيّار
الجياف	NEWMORPH
الجيب	جِيْب,جَيْب
الجيدور	NEWMORPH
الجيزة	جِيزَة
الجيش	جَيْش
الجيفان	NEWMORPH
الجيفة	جِيفَة
الجيل	جِيل
الحاتمية	NEWMORPH
الحاجر	NEWMORPH
الحاذ	NEWMORPH
الحاضر	حاضِر
الحاضرة	حاضِر,حاضِرَة
الحاطمة	حاطِم
الحاكة	حائِك
الحال	حال
الحامرة	NEWMORPH
الحامضة	حامِض
الحاير	NEWMORPH
الحائر	حائِر
الحائط	حائِط
الحبابية	NEWMORPH
الحباحب	حُباحِب
الحبج	NEWMORPH
الحبس	حَبْس,حِبْس
الحبيا	NEWMORPH
الحبيبة	حُبَيْبَة,حَبِيب
الحبير	NEWMORPH
الحت	أَلَحّ,أَلاح
الحتات	حُتات
الحثا	NEWMORPH
الحجارة	حَجّار,حَجَر
الحجاز	حِجاز
الحجائز	NEWMORPH
الحجر	حُجْرَة,حَجَر,حِجْر,حَجْر
الحجلاء	NEWMORPH
الحجلاوان	NEWMORPH
الحجون	NEWMORPH
الحجيب	NEWMORPH
الحجيريات	NEWMORPH
الحجيل	NEWMORPH
الحجيلاء	NEWMORPH
الحدادة	حِدادَة
الحدادية	NEWMORPH
الحدالى	NEWMORPH
الحدباء	أَحْدَب
الحدة	لَحَد-َ,حِدَة,أَلْحَد,حِدَّة
الحدث	حَدَث
الحدثان	حَدَث,حِدْثان
الحديباء	NEWMORPH
الحديبية	حُدَيْبِيَّة
الحديثة	حَدِيث
الحديجاء	NEWMORPH
الحديقا	NEWMORPH
الحديقة	حَدِيقَة
الحذرية	NEWMORPH
الحذنة	NEWMORPH
الحذية	NEWMORPH
الحر	حُرّ,حَرّ
الحرار	حَرّان,حَرّار
الحرامية	حَرامِيّ
الحران	حُرّ,حَرّان
الحربث	NEWMORPH
الحربية	حَرْبِيّ
الحرجة	حَرَج,حَرِج
الحرجلة	NEWMORPH
الحرف	حَرْف,حِرْفَة
الحرقات	NEWMORPH
الحرقة	حُرْقَة
الحرم	حُرْمَة,حَرَم
الحرملية	NEWMORPH
الحرورية	NEWMORPH
الحريرة	حُرَيْرَة
الحريش	NEWMORPH
الحريضة	NEWMORPH
الحريم	حَرِيم
الحز	حَزّ
الحزامون	NEWMORPH
الحزانة	NEWMORPH
الحزم	حُزْمَة,حَزْم,حِزام
الحزمرية	NEWMORPH
الحزيز	NEWMORPH
الحزين	حَزّ,حَزِين
الحسا	NEWMORPH
الحساء	حَساء
الحسانيات	NEWMORPH
الحسبة	حَسَب
الحسن	حَسَن,حُسْن
الحسنان	حَسَن
الحسني	لَحَس-َ,حُسْنِي,لَحِس-َ,أَحْسَن
الحسنية	NEWMORPH
الحسيان	حِسِّيّ
الحشا	حَشاً
الحشاد	NEWMORPH
الحشار	NEWMORPH
الحشاك	NEWMORPH
الحص	حُصّ
الحصاء	NEWMORPH
الحصاب	NEWMORPH
الحصاصة	NEWMORPH
الحصان	حِصان
الحصحاص	NEWMORPH
الحصن	حِصان,حِصْن
الحصنان	NEWMORPH
الحصوص	NEWMORPH
الحصيب	NEWMORPH
الحصيد	حَصِيد
الحصيدات	حَصِيد
الحصيص	NEWMORPH
الحصيلية	NEWMORPH
الحصين	حُصَيْن,حَصِين
الحضر	حَضَر
الحضنان	NEWMORPH
الحضوض	NEWMORPH
الحضيرية	NEWMORPH
الحطمية	NEWMORPH
الحطيم	حَطِيم
الحظائر	حَظِيرَة
الحظيرة	حَظِيرَة
الحفائر	حَفِيرَة
الحفة	لِحاف,أَلْحَف,لَحَف-َ
الحفر	حُفْرَة,حَفْر
الحفرة	حُفْرَة
الحفير	حَفِير
الحفيرة	حَفِيرَة,حَفِير
الحقاب	حُقْب
الحقل	حَقْل
الحقلة	NEWMORPH
الحقو	حَقْو
الحقيبة	حَقِيبَة
الحكامية	NEWMORPH
الحكرة	حُكْرَة
الحككات	NEWMORPH
الحلاءة	NEWMORPH
الحلال	حَلال
الحلاوة	حَلاوَة
الحلائق	NEWMORPH
الحلبة	حَلْبَة
الحلة	حِلَّة,حَلَّة,حُلَّة
الحلمتان	حَلَم
الحليسية	NEWMORPH
الحليف	حَلِيف
الحليفات	حَلِيف
الحليفة	حَلِيف
الحليقة	حَلِيق
الحليل	حَلِيل
الحما	حَم
الحماتان	حَماة
الحمادة	حَمّادة,حَمادَة
الحمارة	حَمّار,حِمارَة
الحمام	حَمام,حَمّام
الحمائر	حِمارَة
الحمائم	حَمام
الحمة	حُمَة,حَمَّة,حُمَّة,لَحَم,لَحِم-َ,لَحَّم
الحمراء	أَحْمَر
الحمى	حُمَة,حَم,حَمِيّ,حِمَى,حُمِّيّ,حُمَّى
الحميراء	NEWMORPH
الحميريون	NEWMORPH
الحميلية	NEWMORPH
الحميمة	حَمِيم
الحناءة	NEWMORPH
الحناءتان	NEWMORPH
الحنابج	NEWMORPH
الحناجر	حَنْجَر
الحناظل	NEWMORPH
الحناك	أَلْحَن,أَلاح
الحنان	حَنان
الحنانة	حَنانَة
الحنبلي	حَنْبَلِيّ
الحندورة	NEWMORPH
الحنفاء	حَنِيف
الحنو	حُنُوّ,حِنْو,حَنْو
الحني	أَلْحَن,أَلَحّ,لاح,لَحا,لَحَى,حَنْي,لَحَّن,أَلاح,لَحَن-َ
الحنيبج	NEWMORPH
الحنيظلة	NEWMORPH
الحواب	NEWMORPH
الحواطب	NEWMORPH
الحوامض	حامِض
الحوة	أَلَحّ,لَحا
الحوراء	أَحْوَر
الحوز	حَوْز
الحوش	حَوَش,حَوْش
الحوض	حَوْض
الحوف	حَوْف
الحولة	NEWMORPH
الحومان	NEWMORPH
الحوياء	NEWMORPH
الحويزة	NEWMORPH
الحيار	NEWMORPH
الحيانية	NEWMORPH
الحير	حَيْر
الحيرة	حَيْرَة
الحيز	حَيِّز
الحيق	حَيْق
الحيل	حِيلَة,حَيْل
الحيمة	NEWMORPH
الخابران	NEWMORPH
الخابور	خابُور
الخارف	NEWMORPH
الخافقان	خافِق
الخافقين	خافِق
الخال	خال
الخالدية	خالِدِيَّة
الخانقان	خانِق
الخانقة	خانِق
الخانوقة	NEWMORPH
الخائع	NEWMORPH
الخائعان	NEWMORPH
الخب	خَبّ
الخبار	NEWMORPH
الخبط	خَبْط,لَخْبَط
الخبي	NEWMORPH
الخبيء	NEWMORPH
الخبيرات	خَبِير
الخبيص	خَبِيص
الختل	خَتْل
الخثماء	NEWMORPH
الخدود	خَدّ
الخذوات	NEWMORPH
الخرار	NEWMORPH
الخرارة	NEWMORPH
الخرانق	خِرْنِق
الخربة	خَرِب,خُرْبَة
الخرج	خَرْج
الخرجاء	NEWMORPH
الخرجان	NEWMORPH
الخرسي	NEWMORPH
الخرصان	خِرْص
الخرقاء	أَخْرَق
الخرماء	NEWMORPH
الخرمق	NEWMORPH
الخروبة	خَرُّوبَة
الخريبة	NEWMORPH
الخريجة	خِرِّيج
الخريري	NEWMORPH
الخريزة	NEWMORPH
الخزامين	NEWMORPH
الخزف	خَزَف
الخزيمية	NEWMORPH
الخسمة	NEWMORPH
الخشارم	NEWMORPH
الخشاشان	NEWMORPH
الخشاشة	NEWMORPH
الخشال	NEWMORPH
الخشباء	NEWMORPH
الخشبي	خَشَبِيّ
الخشبية	خَشَبِيّ
الخشرب	NEWMORPH
الخشرمة	NEWMORPH
الخص	لَخَّص,خَصّ,خُصّ
الخصاصة	خَصاصَة,خَصاص
الخصافة	NEWMORPH
الخصوص	خُصُوص
الخصوف	NEWMORPH
الخصي	خَصِيّ,خُصْيَة
الخصيتان	خُصْيَة
الخضارم	خِضْرِم
الخضر	خَضِر,خُضْرَة,خُضْر
الخضراء	أَخْضَر
الخضرمة	NEWMORPH
الخضمات	NEWMORPH
الخضيرية	NEWMORPH
الخط	خَطّ
الخطابة	خَطابَة,خِطابَة
الخطامة	NEWMORPH
الخطائم	NEWMORPH
الخطط	خُطَّة
الخطمي	NEWMORPH
الخظا	NEWMORPH
الخل	خَلّ
الخلاقى	NEWMORPH
الخلائق	خَلِيق
الخلد	خَلَد,خُلْد
الخلصاء	NEWMORPH
الخلصة	NEWMORPH
الخلقدونة	NEWMORPH
الخليج	خَلِيج
الخليصاء	NEWMORPH
الخليف	NEWMORPH
الخليقة	خَلِيق
الخليل	خَلِيل
الخنافس	خُنْفُس
الخندق	خَنْدَق
الخنزة	NEWMORPH
الخنفس	خُنْفُس
الخنق	خَنْق
الخنوقة	NEWMORPH
الخنيفغان	NEWMORPH
الخوار	خُوار,خَوّار
الخوان	خائِن,خَوّان,خُوان
الخوانق	خانِق,خُناق
الخوة	خُوَّة
الخور	خَوْر,خَوَر
الخورنق	NEWMORPH
الخوز	NEWMORPH
الخوزيون	NEWMORPH
الخويلاء	NEWMORPH
الخيال	خَيّال,خَيال
الخيزران	NEWMORPH
الخيس	خَيْس
الخيمات	خَيْمَة
الخيمة	خَيْمَة
الدار	دار,دارّ
الدارة	دارَة,دارّ
الداروم	NEWMORPH
الدال	دالّ,دال
الدالية	دالِيَة
الدام	NEWMORPH
الداهرية	NEWMORPH
الدبة	دَبَّة,دُبّ
الدبر	دُبْر
الدبيرة	NEWMORPH
الدبيقية	NEWMORPH
الدثينة	NEWMORPH
الدجنتين	NEWMORPH
الدجنيتان	NEWMORPH
الدحادح	NEWMORPH
الدحائل	NEWMORPH
الدحرض	NEWMORPH
الدحول	NEWMORPH
الدخول	دُخُول
الدراج	دُرّاج
الدراجية	NEWMORPH
الدرب	دَرْب
الدرزبينية	NEWMORPH
الدرك	دَرِك,دَرَك
الدرهمة	NEWMORPH
الدروقرة	NEWMORPH
الدريعاء	NEWMORPH
الدسكرة	دَسْكَرَة
الدشت	دَشْت
الدعجاء	أَدْعَج
الدف	دَفّ,دُفّ
الدفن	دَفْن
الدفين	دَفّ,دَفِين,دُفّ
الدفينة	دَفِينَة,دَفِين
الدكان	دُكّان
الدكة	دِكَّة,دَكَّة
الدماج	NEWMORPH
الدماخ	NEWMORPH
الدمعانة	NEWMORPH
الدملوة	NEWMORPH
الدناح	NEWMORPH
الدنان	دِنان
الدنن	NEWMORPH
الدهاسة	NEWMORPH
الدهالك	NEWMORPH
الدهناء	دَهْناء
الدهيم	NEWMORPH
الدو	NEWMORPH
الدواع	NEWMORPH
الدوانك	NEWMORPH
الدوداء	NEWMORPH
الدور	دار,دَوْر
الدورق	دَوْرَق
الدولعية	NEWMORPH
الدونكان	NEWMORPH
الدويرة	NEWMORPH
الدويس	NEWMORPH
الدويمة	NEWMORPH
الديبجات	NEWMORPH
الديبل	NEWMORPH
الديدان	دُود
الديرتان	NEWMORPH
الديكدان	NEWMORPH
الدينباذ	NEWMORPH
الذبابة	ذُباب,ذُبابَة
الذحل	ذَحْل
الذرانح	NEWMORPH
الذرائب	NEWMORPH
الذربة	ذَرِب
الذناب	NEWMORPH
الذنابة	NEWMORPH
الذنائب	NEWMORPH
الذنبة	NEWMORPH
الذنوب	ذَنْب
الذهاب	ذَهاب
الذهبانية	NEWMORPH
الذهلول	NEWMORPH
الذؤيب	NEWMORPH
الذؤيبان	NEWMORPH
الذئب	ذِئْب
الذئبة	NEWMORPH
الذئبين	ذِئْب
الراحة	راحَة
الراشدية	NEWMORPH
الرافدان	رافِد
الرافقة	NEWMORPH
الران	NEWMORPH
الراوندان	NEWMORPH
الراية	رايَة
الرائعة	رائِع,رائِعَة
الرائغة	NEWMORPH
الربا	رِبا
الربان	رُبّان,رَبّ
الربانية	رَبّانِيّ,رُبّان
الربايض	NEWMORPH
الربايع	NEWMORPH
الربة	رَبَّة,رِبَّة,رَبّ
الربذة	NEWMORPH
الربض	رَبَض
الربعة	رَبْعَة
الربو	رَبْو
الربيع	رَبِيع
الرجا	رَجاء,رَجا
الرجاز	NEWMORPH
الرجراجة	NEWMORPH
الرجل	رَجُل,رِجْل
الرجلاء	NEWMORPH
الرجيعة	NEWMORPH
الرجيلاء	NEWMORPH
الرحاب	رِحاب
الرحابة	رَحابَة
الرحبة	رَحْبَة,رَحْب
الرحضية	NEWMORPH
الرحيب	رَحِيب
الرحيل	رَحِيل
الرخجية	NEWMORPH
الرخم	رَخَم
الرخيخ	NEWMORPH
الرخيمة	رَخِيم
الرد	رَدّ
الرداعة	NEWMORPH
الرده	رَدَّة
الردوف	NEWMORPH
الرذ	NEWMORPH
الرزق	رِزْق
الرس	NEWMORPH
الرستمية	NEWMORPH
الرستن	NEWMORPH
الرسيس	NEWMORPH
الرسيع	NEWMORPH
الرشاء	رِشاء
الرصافة	رَصّاف,رَصافَة
الرصد	رَصْد,رَصَد
الرصيعية	NEWMORPH
الرضاب	رُضاب
الرضراضة	NEWMORPH
الرضم	رَضْم
الرضمة	NEWMORPH
الرط	NEWMORPH
الرطيلاء	NEWMORPH
الرعشاء	NEWMORPH
الرعشنة	NEWMORPH
الرعناء	NEWMORPH
الرغام	رَغام,رُغام
الرفدة	NEWMORPH
الرفون	NEWMORPH
الرفيق	رَفِيق
الرقاشان	NEWMORPH
الرقاع	رَقّاع,رُقْعَة
الرقاق	رُقاق,رِقاق,رَقِيق
الرقبتان	رَقَبَة
الرقة	رِقَّة
الرقتان	NEWMORPH
الرقراق	رَقْراق
الرقعة	رُقْعَة
الرقق	NEWMORPH
الرقمتان	NEWMORPH
الرقي	رُقْيَة,رُقِيّ
الرقيبة	NEWMORPH
الرقيدات	NEWMORPH
الرقيعي	NEWMORPH
الرقيق	رَقِيق
الرقيم	رَقِيم
الركاء	NEWMORPH
الركابية	NEWMORPH
الركايا	NEWMORPH
الركب	رِكاب,رُكْبَة,رَكْب
الرماحة	رَمّاح
الرمادة	NEWMORPH
الرمانتان	رُمّان,رُمّانَة
الرمة	رُمَّة,رِمَّة
الرمث	رَمَث
الرمد	رَمَد,رَمِد
الرمص	رَمَص
الرمل	رَمْل
الرملة	رَمْلَة
الرميثة	رُمَيْثَة
الرميلة	رُمَيْلَة
الرنقاء	NEWMORPH
الرهاء	رَهْو,رُهاء
الرهافة	NEWMORPH
الرهيمة	NEWMORPH
الرواء	رِواء,رُواء,رَواء
الرواح	رَواح
الرواطي	NEWMORPH
الروج	رُوج
الروحاء	رَوْحاء,أَرْوَح
الروحان	NEWMORPH
الروذ	NEWMORPH
الرور	NEWMORPH
الروع	رُوع,رَوْع
الروم	رَوْم,رُوم
الروماني	رُومانِيّ
الرومقان	NEWMORPH
الرويتج	NEWMORPH
الرويثات	NEWMORPH
الرويثة	NEWMORPH
الرويحان	NEWMORPH
الرويل	NEWMORPH
الري	رَيّ
الرياحية	NEWMORPH
الرئال	NEWMORPH
الريان	رَيّان,رِيان
الريب	رَيْب,رِيبَة
الريث	NEWMORPH
الريغذمون	NEWMORPH
الزاب	NEWMORPH
الزابج	NEWMORPH
الزابوقة	NEWMORPH
الزارة	NEWMORPH
الزاهرية	NEWMORPH
الزاوية	زاوِيَة
الزباء	أَزَبّ
الزباوان	NEWMORPH
الزبح	NEWMORPH
الزبداني	NEWMORPH
الزبيدية	NEWMORPH
الزبير	زُبَيْر
الزبيرذان	NEWMORPH
الزبيية	NEWMORPH
الزج	أَزَجّ,زُجّ,لَزِج-َ
الزجاجة	زَجّاج,زُجاجَة,زِجاجَة
الزجاجلة	NEWMORPH
الزحر	NEWMORPH
الزحف	زَحْف
الزراب	NEWMORPH
الزراعة	زَرّاع,زِراعَة
الزرائب	زَرِيبَة
الزرقاء	زَرْقاء,أَزْرَق
الزريب	NEWMORPH
الزز	لَزَّز,لَزّ
الزط	NEWMORPH
الزعابة	NEWMORPH
الزعازع	زَعْزَعَة
الزعبلة	NEWMORPH
الزعفرانية	NEWMORPH
الزعل	زَعَل,زَعِل
الزعلاء	NEWMORPH
الزغباء	NEWMORPH
الزغيبة	NEWMORPH
الزقاق	زَقّ,زُقاق
الزلاقة	زَلّاقَة,زَلاقَة
الزملقى	NEWMORPH
الزميل	زَمِيل
الزناء	زِناء
الزهراء	أَزْهَر,زَهْراء
الزهري	زُهَرِيّ
الزهيرية	NEWMORPH
الزواخي	NEWMORPH
الزور	زَوَر,أَزْوَر,زُور,زَوْر
الزوراء	أَزْوَر
الزوية	NEWMORPH
الزيادية	NEWMORPH
الزيب	NEWMORPH
الزيت	زَيْت
الزيتون	زَيْتُون
الزيتونة	زَيْتُونَة
الزيدي	NEWMORPH
الزيدية	NEWMORPH
الزيزيان	NEWMORPH
الزيمة	زِيمَة,زَيْمَة
الس	أَلَّس,وَلَس-ِ,لاس
الساباط	ساباط
السابورية	NEWMORPH
الساج	ساج
الساجور	NEWMORPH
الساحل	ساحِل
السادة	سَيِّد,سادَة,سادّ
الساعد	ساعِد
السافرية	NEWMORPH
الساقة	ساقَة
السامرة	سامِرَة,سامِر
السانة	NEWMORPH
الساهرة	ساهِر
السائبة	سائِب
السباع	سَبْع
السبخة	سَبَخَة,سَبِخ
السبع	سُبْع,سَبْع
السبعية	NEWMORPH
السبيع	NEWMORPH
السبيلة	NEWMORPH
الستار	سَتّار,سِتار
الستاران	سِتار
الستارة	سِتارَة
الستر	سُتْرَة,سِتار,سِتْر
السحيلة	NEWMORPH
السحيمية	NEWMORPH
السخة	NEWMORPH
السخف	سَخْف
السخيبرة	NEWMORPH
السد	سَدّ,سُدّ
السدرتان	سِدْر,سِدْرَة
السدير	NEWMORPH
السديرة	NEWMORPH
السديق	NEWMORPH
السر	سُرّ,سِرّ
السراة	سارِي,سَراة
السرار	سَرار
السرحة	NEWMORPH
السرد	سَرْد
السرر	سُرَّة
السرمق	NEWMORPH
السرو	سَرْو
السروان	NEWMORPH
السري	سِرِّيّ,سَرِيّ,سُرِّيّ
السرية	سِرِّيّ,سَرِيّ,سُرِّيَّة,سِرِّيَّة,سَرِيَّة,سُرِّيّ
السرير	سَرِير
السطاع	NEWMORPH
السطح	سَطْح
السعافات	NEWMORPH
السعائم	NEWMORPH
السعد	سَعْد
السعدان	سَعْدان
السعدية	سَعْدِيّ
السعديين	سَعْدِيّ
السعيدة	سَعِيد
السغد	NEWMORPH
السفح	سَفْح
السفليون	NEWMORPH
السفوح	سَفْح
السفير	سَفِير
السقاطية	NEWMORPH
السقيا	NEWMORPH
السقيفتان	سَقِيفَة
السكاسك	NEWMORPH
السكران	سَكْران
السكرة	سَكْرَة
السلاسل	سِلْسِلَة
السلالم	سُلَّم
السلام	سَلّام,سَلام
السلامة	سَلامَة
السلامى	سُلامَى
السلامية	سُلامَى
السلان	NEWMORPH
السلائل	سَلِيلَة
السلف	سالِف,سَلَف,سِلْف
السلفين	سِلْف
السلق	سَلْق,سِلْق
السلي	NEWMORPH
السليت	NEWMORPH
السليع	NEWMORPH
السليل	سَلِيل
السليلة	سَلِيلَة
السليم	سَلِيم
السمار	سامِر,سَمار
السماوة	سَماوَة
السمعانية	NEWMORPH
السميعية	NEWMORPH
السمينة	NEWMORPH
السن	أَلَّس,لَيْسَ,سِنّ,لِسان,سَنّ,لَسِن-َ,لَسَّن,أَلْسَن
السنائن	NEWMORPH
السنجلاط	NEWMORPH
السنح	سُنْح
السند	سِنْد,سَنَد
السندروذ	NEWMORPH
السندية	NEWMORPH
السنطة	سَنْطَة
السنمات	NEWMORPH
السهاب	NEWMORPH
السهب	سُهْب
السهل	سَهْل
السهلة	سَهْل
السهلين	سَهْل
السواء	سَواء
السواجير	NEWMORPH
السواد	سَواد
السوادية	NEWMORPH
السوارقية	NEWMORPH
السوارية	سُوارِيه,سَوارِيّ
السواس	سائِس
السواسى	NEWMORPH
السوبان	NEWMORPH
السوج	NEWMORPH
السود	أَسْوَد
السوداء	أَسْوَد
السودة	NEWMORPH
السودتان	NEWMORPH
السودد	NEWMORPH
السور	سُورَة,سُور,سِوار
السورانية	NEWMORPH
السورين	NEWMORPH
السوس	سُوس
السويداء	سُوَيْداء
السي	سِي
السيال	سَيّال
السيالة	سَيّال,سَيّالَة
السيالى	NEWMORPH
السيب	سِيب
السيتعور	NEWMORPH
السيد	سَيِّد
السيدان	سَيِّد
السيديز	NEWMORPH
السيراة	NEWMORPH
السيران	سَيْر
السيرجان	NEWMORPH
السيروان	NEWMORPH
السيرين	سَيْر
السين	سِين
السيوح	NEWMORPH
الش	NEWMORPH
الشاذياخ	NEWMORPH
الشاروف	NEWMORPH
الشاغرة	شاغِر
الشاغور	NEWMORPH
الشام	شام
الشامات	شامَة
الشبا	شَباً
الشباك	شُبّاك,شَبَكَة
الشبعاء	NEWMORPH
الشبعان	شَبْعان
الشبق	شُبُق,شَبِق,شَبَق
الشبكة	شَبَكَة
الشبلية	NEWMORPH
الشبيرمة	NEWMORPH
الشبيك	NEWMORPH
الشبيكة	شَبِيكَة
الشث	NEWMORPH
الشثر	NEWMORPH
الشجان	NEWMORPH
الشجرة	شَجِر,شَجَرَة
الشجرتان	شَجِر,شَجَرَة
الشجي	شَجاً,شَجِيّ,شَجِي
الشجية	شَجِيّ,شَجِي
الشحر	NEWMORPH
الشحم	شَحْم,شَحِم
الشديق	NEWMORPH
الشذف	NEWMORPH
الشراء	شِراء
الشراة	شارِي
الشراشر	شَراشِر
الشربة	شَرْبَة
الشرطة	شُرْطَة,شَرْطَة
الشرع	شَرْع,شَرَع
الشرعبي	NEWMORPH
الشرعبية	NEWMORPH
الشرف	شَرَف
الشرقي	شَرْقِيّ
الشرقية	شَرْقِيّ
الشركة	شَرِكَة
الشروين	NEWMORPH
الشرى	شِرَى,شَرْي
الشري	شِرَى,شَرْي
الشرية	NEWMORPH
الشرير	شَرِير,شِرِّير
الشريف	شَرِيف
الشزب	NEWMORPH
الشطان	NEWMORPH
الشطبتان	NEWMORPH
الشطيبية	NEWMORPH
الشطين	NEWMORPH
الشعبتان	شُعْبَة
الشعر	شِعْر,شَعْر
الشعيبية	NEWMORPH
الشعير	شَعِير
الشغر	NEWMORPH
الشفع	شَفْع
الشفير	شَفِير
الشفيقة	شَفِيق
الشقائق	شَقِيقَة
الشقراء	أَشْقَر
الشقوق	شَقّ
الشقيق	شَقِيق
الشقيقة	شَقِيقَة
الشماخية	NEWMORPH
الشماسية	NEWMORPH
الشمسين	NEWMORPH
الشمطاء	أَشْمَط
الشموس	شَمْس,شَمُوس
الشميستان	NEWMORPH
الشهارسوج	NEWMORPH
الشهب	أَشْهَب,شَهَب,شِهاب
الشهبة	شَهَب
الشهلاء	أَشْهَل
الشهلية	NEWMORPH
الشوبك	شَوْبَك
الشوذر	شَوْذَر
الشورمين	NEWMORPH
الشوش	أَشْوَش
الشونيزية	NEWMORPH
الشويكة	NEWMORPH
الشويلاء	NEWMORPH
الشويلة	NEWMORPH
الشيبانية	شَيْبانِيّ
الشيح	شِيح
الشيحة	NEWMORPH
الشيخة	شَيْخَة
الشيرغاوشون	NEWMORPH
الشيطا	NEWMORPH
الشيطان	شَيْطان
الشيق	شَيِّق
الشيقان	شَيِّق
الصابح	NEWMORPH
الصابر	صابِر
الصابوني	صابُونِيّ
الصادر	صادِر
الصافية	صافِي
الصاقب	NEWMORPH
الصاقرية	NEWMORPH
الصالحية	NEWMORPH
الصبرات	NEWMORPH
الصبغاء	NEWMORPH
الصبيرة	NEWMORPH
الصحصحان	NEWMORPH
الصخرة	صَخْر
الصخيرة	NEWMORPH
الصدارة	صَدارَة
الصدف	صُدْفَة,صَدَف
الصراة	NEWMORPH
الصراد	صُرّاد
الصرائم	NEWMORPH
الصرح	صَرْح
الصردف	NEWMORPH
الصروات	NEWMORPH
الصريد	صُرّاد
الصريف	صَرِيف
الصريم	NEWMORPH
الصريمة	صَرِيمَة
الصعاب	صَعْب
الصعبية	NEWMORPH
الصعصعية	NEWMORPH
الصعيد	صَعِيد
الصعيراء	NEWMORPH
الصغد	NEWMORPH
الصفا	صَفاً
الصفاح	صَفّاح,صُفّاح
الصفاصف	NEWMORPH
الصفافيق	NEWMORPH
الصفة	صُفَّة,صِفَة
الصفر	صِفْر,أَصْفَر,صَفَر
الصفراء	أَصْفَر
الصفراوات	NEWMORPH
الصفرة	صَفْرَة,صُفْرَة
الصفصاف	NEWMORPH
الصفقة	صَفْقَة
الصفوانية	NEWMORPH
الصفيحة	صَفِيحَة
الصفيين	صَفِيّ
الصقلاء	NEWMORPH
الصلب	صُلْب,صَلْب
الصلبان	صُلْب,صَلِيب
الصلح	صُلْح
الصلصلة	صَلْصَلَة
الصلعاء	أَصْلَع
الصلي	NEWMORPH
الصليب	صَلِيب
الصليبة	NEWMORPH
الصليعاء	NEWMORPH
الصليق	NEWMORPH
الصماخ	صِماخ
الصماخى	NEWMORPH
الصمان	أَصَمّ
الصمتان	صَمِت
الصمد	صَمْد,صَمَد
الصمغة	NEWMORPH
الصنبرة	NEWMORPH
الصنبور	صُنْبُور
الصنمان	صَنَم
الصنيفة	NEWMORPH
الصنين	صَنّ
الصهو	NEWMORPH
الصهوة	صَهْوَة
الصوائق	NEWMORPH
الصوائم	NEWMORPH
الصور	صُورَة,صُور
الصوران	NEWMORPH
الصورين	NEWMORPH
الصوقعة	NEWMORPH
الصوير	NEWMORPH
الصياحة	صَيّاح
الصير	NEWMORPH
الصين	صِين
الصينية	صِينِيّ,صِينِيَّة
الضاحي	ضاحِي
الضائن	ضائِن
الضباع	ضَبْع
الضبر	ضَبْر
الضبع	ضَبْع
الضبيب	NEWMORPH
الضجاج	ضَجّاج
الضجاع	NEWMORPH
الضجن	NEWMORPH
الضجوع	ضُجُوع
الضحاكة	ضَحّاك
الضحيان	NEWMORPH
الضراح	NEWMORPH
الضرافة	NEWMORPH
الضريوة	NEWMORPH
الضلعان	ضِلْع
الضمار	NEWMORPH
الضمد	ضَمْد
الضمران	NEWMORPH
الضهياتان	NEWMORPH
الضواجع	NEWMORPH
الضيق	ضِيق,ضَيِّق
الضيقة	ضَيِّق
الطا	NEWMORPH
الطاحونة	طاحُونَة
الطاق	طاق
الطاهرية	NEWMORPH
الطائر	طائِر
الطائف	طائِف
الطبسان	NEWMORPH
الطحي	NEWMORPH
الطراة	NEWMORPH
الطربال	NEWMORPH
الطرغشة	NEWMORPH
الطرفاء	طَرْفاء
الطرم	NEWMORPH
الطريبيل	NEWMORPH
الطريدة	طَرِيد,طَرِيدَة
الطف	لَطَف,لَطُف,أَلْطَف,لَطَّف
الطفاف	NEWMORPH
الطلوية	NEWMORPH
الطماحية	NEWMORPH
الطهمانية	NEWMORPH
الطواء	NEWMORPH
الطواحين	طاحُونَة
الطوب	طُوب
الطوبان	NEWMORPH
الطوبانية	NEWMORPH
الطور	طَوْر
الطوي	طَوَى
الطويلة	طَوِيل
الطيب	طِيب,طَيِّب
الطيبة	طِيبَة,طَيِّب
الطيطوانة	NEWMORPH
الطين	طِين
الطينة	طِينَة
الظاهر	ظاهِر
الظاهرة	ظاهِر,ظاهِرَة
الظاهرية	ظاهِرِيّ,ظاهِرِيَّة
الظباء	ظَبْي
الظرب	NEWMORPH
الظفر	ظَفِر,ظُفُر,ظَفَر
الظفرية	NEWMORPH
الظفير	NEWMORPH
الظهار	ظِهار
الظهر	ظَهْر,ظُهْر
الظهران	ظَهْر,ظَهْران
الظويلمية	NEWMORPH
العازرية	NEWMORPH
العاصمية	عاصِمِيّ
العاصي	عاصِي
العاقرة	NEWMORPH
العال	إِلْعال,عال
العاليات	عالِي
العالية	عالِي,عالِيَة
العامرية	عامِرِيَّة
العاه	NEWMORPH
العبابيد	NEWMORPH
العبادية	NEWMORPH
العباسة	NEWMORPH
العباسية	عَبّاسِيّ
العبامة	NEWMORPH
العبد	عَبْد
العبر	عَبْر,عَبْرَ,عِبْرَة
العبرات	عَبْرَة
العبرة	عَبْرَة,عِبْرَة
العبسية	NEWMORPH
العبلاء	NEWMORPH
العبيلاء	NEWMORPH
العتر	NEWMORPH
العتيد	عَتِيد
العتيق	عَتِيق
العتيقة	عَتِيق
العتيكية	NEWMORPH
العثانة	NEWMORPH
العثجلية	NEWMORPH
العثير	عِثْيَر
العجاج	عَجّاج,عَجاج
العجرد	NEWMORPH
العجروم	NEWMORPH
العجلانية	NEWMORPH
العجلة	عَجَلَة
العجماء	عَجْماء,أَعْجَم
العجول	عِجْل,عَجُول
العداف	NEWMORPH
العدوية	عَدَوِيَّة
العذبات	NEWMORPH
العذي	عَذِيّ
العذيب	NEWMORPH
العذيبة	NEWMORPH
العر	NEWMORPH
العرابة	عَرّاب
العرادة	عَرّادَة
العراق	عِراق
العراقان	NEWMORPH
العرائس	عَرُوس
العرج	عَرَج
العرجاء	أَعْرَج
العرجة	عَرَجَة
العردة	NEWMORPH
العرساء	NEWMORPH
العرش	عَرْش
العرض	عَرَض,عَرْض,عِرْض
العرف	عُرْف
العرفة	عَرَفَة
العرق	عَرَق,عِرْق
العرقان	عِرْق,عَرْقان
العرقة	NEWMORPH
العرقوب	عُرْقُوب
العرم	عَرِم,عُرْمَة
العرمان	عَرِم,عِرْمان
العرمة	عَرِم,عَرِمَة,عُرْمَة
العرناس	عِرْناس
العروب	NEWMORPH
العروس	عَرُوس
العروسين	عَرُوس
العروش	عَرْش
العروض	عَرْض,عَرُوض
العروق	عِرْق
العروند	NEWMORPH
العري	عُرْوَة,عُرْي
العريمة	NEWMORPH
العرين	عَرِين
العزاف	NEWMORPH
العزف	عَزْف
العزل	أَعْزَل,عَزْل
العزى	عُزَّى
العزيزية	عَزِيزِيّ
العزيف	عَزِيف
العزيلة	NEWMORPH
العس	أَلْعَس,عَسّ
العسجدية	عَسْجَدِيّ
العسلة	NEWMORPH
العسير	عَسِير
العسيلة	NEWMORPH
العش	عُشّ
العشائر	عَشِيرَة
العشة	عُشَّة
العشتان	عُشَّة
العشير	عَشِير
العشيرة	عَشِيرَة,عَشِير
العصا	عَصاً
العصلاوان	NEWMORPH
العصم	عَصْم,أَعْصَم
العصيب	عَصِيب
العضدية	NEWMORPH
العضل	عَضِل,عَضْل,عَضَل
العطش	عَطَش,عَطِش
العطف	عَطْف,عِطْف,عِطاف
العظاءة	عِظاءَة
العظالى	NEWMORPH
العظوم	NEWMORPH
العفافة	NEWMORPH
العفيف	عَفِيف
العقاب	عُقاب,عِقاب
العقار	عَقار,عَقّار
العقر	عُقْر,عاقِر
العقربة	NEWMORPH
العقوبان	NEWMORPH
العقور	عَقُور
العقير	NEWMORPH
العقيرة	عَقِيرَة
العقيق	عَقِيق
العكرشة	NEWMORPH
العكلية	NEWMORPH
العلا	عَلا
العلاء	عَلاء
العلاة	عَلاة
العلاتان	عَلاة
العلاقمة	NEWMORPH
العلاقي	عَلاقِيّ
العلانة	NEWMORPH
العلاية	عَلايَة
العلث	NEWMORPH
العلدة	NEWMORPH
العلم	عِلْم,عَلَم
العلندى	NEWMORPH
العلوي	عَلَوِيّ,عُلْوِيّ
العليب	NEWMORPH
العليبة	عُلَيْبَة
العلية	عُلِيَّة,عَلِيّ,عِلْيَة,عِلِّيَّة
العم	عَمّ
العماد	عِماد
العمادية	NEWMORPH
العمارة	عِمارَة,عَمارَة
العمارية	عَمّارِيَّة
العماكر	NEWMORPH
العمرانية	عُمْرانِيّ
العمرية	عُمْرِيّ
العمق	عَمِيق,عُمْق
العمقة	NEWMORPH
العمقى	NEWMORPH
العمير	عُمَيْر
العميس	NEWMORPH
العميم	عَمِيم
العناب	عُنّاب
العنابة	عَنّابَة,عُنّاب
العناج	عِناج
العناقة	NEWMORPH
العنبرة	NEWMORPH
العنصلان	عُنْصُل
العنك	لَعَن-َ
العنيق	NEWMORPH
العوادر	NEWMORPH
العواصم	عاصِمَة
العواقر	عاقِر
العوالي	عالِيَة
العوالية	NEWMORPH
العوانة	عَوان
العوجاء	أَعْوَج
العوجان	NEWMORPH
العوراء	أَعْوَر
العوسج	عَوْسَج
العوصاء	NEWMORPH
العوقبان	NEWMORPH
العونيد	NEWMORPH
العويط	NEWMORPH
العويند	NEWMORPH
العيرات	NEWMORPH
العيرة	عِيرَة
العيزارة	NEWMORPH
العيص	NEWMORPH
العيصان	NEWMORPH
العين	عَيْن
العيون	عُيُون,عَيْن
الغابة	غابَة
الغار	غار
الغاضرية	NEWMORPH
الغامرية	NEWMORPH
الغائط	غائِط
الغبارات	NEWMORPH
الغبارة	NEWMORPH
الغبارى	NEWMORPH
الغبر	غَبِر,أَغْبَر
الغبراء	أَغْبَر
الغبرة	غَبِر,غَبَرَة,غُبْرَة
الغبغب	NEWMORPH
الغبير	NEWMORPH
الغبيط	NEWMORPH
الغبيطان	NEWMORPH
الغثاة	NEWMORPH
الغر	غِرّ,أَغَرّ
الغراء	غِراء,أَغَرّ
الغرابات	NEWMORPH
الغرابة	غَرابَة
الغرابي	NEWMORPH
الغراف	غَرّاف
الغراميل	NEWMORPH
الغران	NEWMORPH
الغربات	NEWMORPH
الغرتان	NEWMORPH
الغرد	غُرْد,غَرَد
الغرس	غَرْس
الغرفي	NEWMORPH
الغرقدة	NEWMORPH
الغرنق	NEWMORPH
الغرو	غَرْو
الغري	NEWMORPH
الغريان	NEWMORPH
الغرية	NEWMORPH
الغريراء	NEWMORPH
الغريز	NEWMORPH
الغريض	غَرِيض
الغريفة	NEWMORPH
الغريق	غَرِيق
الغزيز	NEWMORPH
الغزيل	NEWMORPH
الغسولة	NEWMORPH
الغصن	غُصْن
الغضا	NEWMORPH
الغضاب	غَضْبان
الغضاض	NEWMORPH
الغضبان	غَضِب,غَضْبان
الغضي	غَضَى
الغطاط	NEWMORPH
الغفارتين	غِفارَة
الغفارية	NEWMORPH
الغلغلة	NEWMORPH
الغماد	NEWMORPH
الغمار	غَمْرَة
الغمر	غَمْر
الغمران	NEWMORPH
الغمرية	NEWMORPH
الغمل	NEWMORPH
الغموض	غُمُوض
الغميس	غَمِيس
الغميسة	غَمِيس
الغميصاء	NEWMORPH
الغميم	NEWMORPH
الغناء	غَناء,غِناء,أَغَنّ
الغوارة	NEWMORPH
الغور	غَوْر
الغورة	NEWMORPH
الغوطة	غُوطَة
الغوير	NEWMORPH
الغيض	غَيْض
الغيضة	غَيْضَة
الغيلة	غِيلَة
الغيلم	غَيْلَم
الغين	غَيْن,أَلْغَى
الفاخرة	فاخِر
الفارسكر	NEWMORPH
الفارسية	فارِسِيّ,فارِسِيَّة
الفاروث	NEWMORPH
الفائحة	NEWMORPH
الفتات	فُتات
الفتين	أَلْفَت,آلِف
الفجيرة	فُجَيْرَة
الفحص	فَحْص
الفحفاح	NEWMORPH
الفحلاء	NEWMORPH
الفحلان	NEWMORPH
الفحلتان	NEWMORPH
الفدين	NEWMORPH
الفراء	فَرْوَة,فَراء,فَرّاء
الفرات	فُرات
الفراخ	فِراخ
الفرادخ	NEWMORPH
الفراديس	فِرْدَوْس
الفرج	فَرَج,فَرْج
الفرجان	NEWMORPH
الفرد	فَرْد
الفردة	فَرْد
الفردين	فَرْد
الفرزة	NEWMORPH
الفرزل	NEWMORPH
الفرس	فارِسِيّ,فَرَس
الفرش	فَرْش,فُرْشَة
الفرضة	فُرْضَة
الفرع	فَرْع
الفرعة	NEWMORPH
الفرغ	فَرِغ
الفرك	فَرْك
الفرما	NEWMORPH
الفروان	فَرّاء
الفرود	فَرْد
الفروسيج	NEWMORPH
الفروع	فَرْع
الفروق	فَرُوق,فَرْق,فِرْقَة
الفسطاط	فُسْطاط
الفشن	NEWMORPH
الفص	فَصّ
الفصا	NEWMORPH
الفضاء	فَضاء
الفضاض	NEWMORPH
الفضل	فَضْل
الفضلية	NEWMORPH
الفغواء	NEWMORPH
الفغوة	فَغْوَة
الفقء	فَقْء
الفقاة	NEWMORPH
الفقار	فَقار
الفقتين	NEWMORPH
الفقي	فَقِيّ
الفقير	فَقِير
الفلا	فِيلّا,فَلاً
الفلاليج	NEWMORPH
الفلس	فِلْس
الفلق	فَلْق
الفلوجة	فَلُّوجَة
الفليق	NEWMORPH
الفناة	أَلَّف,أَلِف-َ,آلَف
الفندق	فُنْدُق
الفندم	NEWMORPH
الفنيدق	NEWMORPH
الفنيق	NEWMORPH
الفهدات	NEWMORPH
الفهدة	NEWMORPH
الفهرج	NEWMORPH
الفهميين	NEWMORPH
الفوارة	فَوّارَة
الفوارس	فارِس
الفوارع	NEWMORPH
الفودجات	NEWMORPH
الفور	فَوْرَ,فَوْر
الفوعة	فَوْعَة
الفولة	فُول
الفياشل	NEWMORPH
الفيجة	NEWMORPH
الفيض	فَيْض
الفيوم	فَيُّوم
القابل	قابِل
القابلة	قابِل
القاحة	قاحَة
القادسية	قادِسِيَّة
القادمة	قادِم,قادِمَة
القاطول	NEWMORPH
القاع	قاع
القاعة	قاعَة
القاقزان	NEWMORPH
القامة	قامَة
القانون	قانُون
القاهرة	قاهِرَة
القاوية	NEWMORPH
القائم	قائِم
القائمة	قائِمَة,قائِم
القباب	قُبَّة
القبابة	NEWMORPH
القبائض	NEWMORPH
القبلار	NEWMORPH
القبلية	قَبَلِيّ,قِبْلِيّ,قَبْلِيّ
القبيبات	قُبَيْبَة
القبيصة	NEWMORPH
القتود	NEWMORPH
القحمة	قُحْمَة
القدامي	قَدِيم
القدس	قُدْس,قُدُس
القدوم	قادِم,قَدُّوم,قُدُوم,قَدُوم
القدونين	NEWMORPH
القديمة	قَدِيم
القذاف	قَذّاف
القراري	NEWMORPH
القرافة	قَرافَة
القرانع	NEWMORPH
القرائن	قَرِينَة
القرة	قِرَّة,قُرَّة
القرتب	NEWMORPH
القرحاء	NEWMORPH
القردودة	NEWMORPH
القردية	قِرْدِيّ
القرشية	قُرَشِيّ
القرع	قَرْع,قُرْعَة,قَرَع,قُرْع
القرعاء	أَقْرَع
القرفية	NEWMORPH
القرنتان	قُرْنَة
القرنين	قَرْن
القرو	قَرْو
القروط	قُرْط
القروق	NEWMORPH
القرى	قَرْيَة,قِرَى
القريات	NEWMORPH
القرية	قَرْيَة,قَرِيَّة
القريتان	قَرْيَة,قَرِيَّة
القريش	قُرَيْش
القريشية	قُرَيْشِيّ
القريظ	NEWMORPH
القريق	NEWMORPH
القرين	قَرِين
القرينة	قَرِينَة
القرينتان	قَرِينَة
القرينين	قَرِين
القريين	NEWMORPH
القزية	قَزِّيّ
القس	قَسّ
القسطل	قَسْطَل
القسم	قَسَم,قِسْم
القسميات	NEWMORPH
القسوميات	NEWMORPH
القسومية	NEWMORPH
القسيم	قُسَيْم,قَسِيم
القشر	قِشْر
القشم	NEWMORPH
القشيب	قَشِيب
القصا	قَصَى
القصبات	قَصَب
القصة	قِصَّة,قَصَّة
القصر	قاصِر,قَصَر,قَصْر,قِصَر
القصران	قَصْر
القصيبة	قُصَيْبَة
القصير	قَصِير
القصيعة	NEWMORPH
القصيم	قَصِيم
القضيب	قَضِيب
القطائط	NEWMORPH
القطائع	قَطِيعَة
القطب	قُطْب
القطبيات	NEWMORPH
القطبية	قُطْبِيَّة,قُطْبِيّ
القطرية	قُطْرِيّ,قَطَرِيّ
القطعاء	أَقْطَع
القطقطانة	NEWMORPH
القطم	قَطْم
القطيف	قَطِيف
القطيفة	قَطِيفَة
القعاقع	قَعْقَعَة
القعر	قَعْر
القعراء	NEWMORPH
القعقاع	NEWMORPH
القعمة	NEWMORPH
القف	لَقِف-َ
القفاعة	NEWMORPH
القفال	قافِل,قَفّال
القفس	NEWMORPH
القفص	قَفَص
القفو	NEWMORPH
القفيان	NEWMORPH
القفير	قَفِير
القلادة	قِلادَة
القلت	NEWMORPH
القلتان	قُلَّة
القلتين	قُلَّة
القلخ	NEWMORPH
القلزم	NEWMORPH
القلعة	قَلْعَة
القلمون	NEWMORPH
القليب	NEWMORPH
القليس	NEWMORPH
القليعة	NEWMORPH
القمرايضا	NEWMORPH
القمعة	NEWMORPH
القموص	NEWMORPH
القنابة	NEWMORPH
القناطر	قَنْطَرَة,قَناطِر
القنافذ	قُنْفُذ
القنافية	NEWMORPH
القنان	قُنَّة,قُنّ
القنانان	NEWMORPH
القناية	قَنايَة
القنة	لَقِن-َ,قُنَّة,لَقَّن,أَلَق-ِ
القندل	NEWMORPH
القنع	قَنِع,قَنَع,قِناع,قِنْع
القنفذة	NEWMORPH
القنيعة	NEWMORPH
القنينيات	NEWMORPH
القهر	قَهْر
القهز	NEWMORPH
القوادس	قادِس
القوادم	قادِمَة
القوارة	NEWMORPH
القواصر	NEWMORPH
القواعل	NEWMORPH
القوائم	قائِمَة
القوبع	NEWMORPH
القورج	NEWMORPH
القويرة	NEWMORPH
القويلية	NEWMORPH
القوينصة	NEWMORPH
القي	لَقِي-َ,قِياء,أَلَق,أَلْقَى
القيار	NEWMORPH
القيارة	NEWMORPH
القيبار	NEWMORPH
القيدة	NEWMORPH
القيروان	قَيْرَوان
القيصومة	NEWMORPH
القيقاء	NEWMORPH
القين	قَيْن,أَلْقَى
الكاثب	NEWMORPH
الكاف	كاف
الكامسة	NEWMORPH
الكاهلة	NEWMORPH
الكبوان	NEWMORPH
الكبيبة	كُبَيْبَة
الكثيب	كَثِيب
الكحيل	كَحِيل
الكديد	NEWMORPH
الكديدة	NEWMORPH
الكر	كَرّ
الكراث	كَرّاث
الكرج	كُرْج
الكرخ	NEWMORPH
الكرس	NEWMORPH
الكرش	كِرْش
الكرية	كَرِيه,كُرَيَّة,كُرِيّ
الكرير	كَرِير
الكسر	كَسْر
الكسوة	كِسْوَة
الكعبات	NEWMORPH
الكعبة	كَعْبَة
الكفاف	كِفاف,كَفاف,كِفَّة
الكفتة	كُفْتَة
الكفئان	NEWMORPH
الكفين	كَفّ
الكلاء	NEWMORPH
الكلاب	كُلّاب,كَلْب
الكلاخ	NEWMORPH
الكلب	كَلِب,كَلَب,كَلْب
الكلتانية	NEWMORPH
الكليبين	كَلِيب
الكناسة	كُناسَة,كَنّاس
الكنيزة	NEWMORPH
الكنيسة	كَنِيسَة
الكهرجان	NEWMORPH
الكهف	كَهْف
الكهفة	NEWMORPH
الكواثل	NEWMORPH
الكواشى	NEWMORPH
الكوافر	NEWMORPH
الكور	كُورَة,كُور
الكوفة	كُوفَة
الكوكبية	كَوْكَبِيّ
الكولة	NEWMORPH
الكويرة	NEWMORPH
الكويفة	NEWMORPH
اللاءة	NEWMORPH
اللاب	NEWMORPH
اللابتان	NEWMORPH
اللات	NEWMORPH
اللاذقية	لاذِقِيَّة
اللار	NEWMORPH
اللان	NEWMORPH
اللبا	NEWMORPH
اللبادين	NEWMORPH
اللبان	لَبِنَة,لُبان,لَبّان,لَبَن,لِبان,لُبانَة
اللبد	لِبْدَة,لُبَد,لِبْد,لَبِد,لَبَد
اللبنتان	لِبْنَة,لِبْن
اللبيين	NEWMORPH
اللجاة	NEWMORPH
اللجم	لِجام,لَجْم
اللجون	NEWMORPH
اللحيان	لَحْي
اللخ	NEWMORPH
اللدمان	NEWMORPH
اللر	NEWMORPH
اللسان	لِسان
اللطاط	NEWMORPH
اللفاظ	NEWMORPH
اللقاطة	لُقاط
اللقيطة	لَقِيط
اللكاك	NEWMORPH
اللكام	NEWMORPH
اللكمة	لَكْمَة
اللمعية	NEWMORPH
اللهابة	NEWMORPH
اللهاله	NEWMORPH
اللهباء	NEWMORPH
اللهواء	NEWMORPH
اللهيب	لَهِيب
اللهيماء	NEWMORPH
اللواسي	NEWMORPH
اللوالجان	NEWMORPH
اللوح	لَوْح
اللور	لُور
اللورجان	NEWMORPH
اللوزة	لَوْز
اللوزية	لَوْزِيّ
اللوقة	NEWMORPH
اللؤلؤة	لُؤْلُؤ
اللوى	لِوَى,لَوَى,لَيَّة
الليث	لَيْث
الليط	NEWMORPH
الليمة	NEWMORPH
اللين	لِين,لَيِّن
الماءتين	NEWMORPH
الماتمة	NEWMORPH
الماثب	NEWMORPH
الماثول	NEWMORPH
الماجل	ماجِل
المازحين	مازِح
المازمان	NEWMORPH
الماطرون	NEWMORPH
المالكية	مالِكِيَّة,مالِكِيّ
المامونية	NEWMORPH
المبارك	مُبارَك
المباركة	مُبارَكَة,مُبارَك
المباركية	NEWMORPH
المتثلم	مُتَثَلِّم
المتوكلية	NEWMORPH
المثاني	NEWMORPH
المثقب	NEWMORPH
المثل	مِثْل,مَثَل
المثلم	NEWMORPH
المثناة	مُثَنَّى
المجاز	مَجاز,مُجاز
المجازة	مُجاز
المجتبية	NEWMORPH
المجدية	مُجْدِي,مَجْدِيّ
المجرة	NEWMORPH
المجزل	NEWMORPH
المجمر	NEWMORPH
المجمعة	مُجَمَّع,مُجْمَع,مُجَمِّع
المجيث	NEWMORPH
المجيمر	NEWMORPH
المحاقرة	NEWMORPH
المحالب	NEWMORPH
المحجة	مَحَجَّة
المحدث	مُحْدَث
المحدثة	مُحْدَث
المحدود	مَحْدُود
المحرق	مَحْرَق,مُحَرِّق,مُحْرَق
المحرقة	مَحْرَقَة,مُحَرِّق,مُحْرَق
المحروم	مَحْرُوم
المحصب	NEWMORPH
المحضة	NEWMORPH
المحلبيات	NEWMORPH
المحلبية	NEWMORPH
المحلة	مَحَلَّة
المحمة	NEWMORPH
المحمديات	مُحَمَّدِيّ
المحمدية	مُحَمَّدِيّ
المحو	مَحْو
المحول	مُحَوِّل
المحيصر	NEWMORPH
المحيلية	NEWMORPH
المخا	مُخا
المخابط	مِخْبَط
المختار	مُخْتار
المختارة	مُخْتار
المخراف	NEWMORPH
المخرفين	مُخَرِّف
المخرم	مُخَرَّم
المخلدية	NEWMORPH
المخلفة	مُخَلَّف
المخمص	NEWMORPH
المخيم	مُخَيَّم
المدار	مَدار
المدان	مُدان
المدائن	مَدائِن,مَدِينَة
المدجج	مُدَجَّج
المدر	مُدِرّ,مَدَر
المدراء	مُدِير
المدراة	مِدْراة
المدرة	مُدِرّ,مَدَرَة,مِدْرَه,مِدْراة
المدركة	مُدْرِك
المدلاء	NEWMORPH
المدور	مُدَوَّر
المديبر	NEWMORPH
المديدان	مَدِيد
المذاد	NEWMORPH
المذار	NEWMORPH
المذارع	NEWMORPH
المذاهب	مَذْهَب
المذر	مَذِر,مَذَر
المذرى	مِذْرَى
المذنب	مُذَنَّب,مُذْنِب
المذيخرة	NEWMORPH
المر	مَرّ,مُرّ
المرابد	NEWMORPH
المراتب	مَرْتَبَة
المراح	مِراح,مُراح,مَراح
المراحضة	NEWMORPH
المرار	مِرار
المراض	NEWMORPH
المراضان	NEWMORPH
المراقب	مُراقَب,مِرْقَب,مُراقِب,مَرْقَب
المراكب	مَرْكَب
المران	مُرّ,مِران
المراوزة	NEWMORPH
المرايض	NEWMORPH
المرايغ	NEWMORPH
المربد	مُرَبَّد
المربع	مُرَبَّع,مَرْبَع
المربوع	مَرْبُوع
المرتاحية	NEWMORPH
المرتمى	NEWMORPH
المرختان	مَرِخ
المردات	NEWMORPH
المردمة	NEWMORPH
المرزى	NEWMORPH
المرسلية	مُرْسَلِيَّة
المرعدة	NEWMORPH
المرغاب	NEWMORPH
المرغابان	NEWMORPH
المرقب	مِرْقَب,مَرْقَب
المرقبة	مَرْقَب
المرقدة	مُرَقِّد
المرمى	مَرْمَى,مَرْمِيّ
المروان	مَرْوان
المروة	مُرُوَّة,مَرْوَة
المروت	NEWMORPH
المروحة	مِرْوَحَة
المرود	مِرْوَد
المرية	مُرْيَة
المريداء	NEWMORPH
المرير	مَرِير
المريرة	مَرِيرَة,مَرِير
المريزجان	NEWMORPH
المريسة	مَرِيسَة
المريسيع	NEWMORPH
المريط	مَرِيط
المزاج	مِزاج
المزاهر	مَزاهِر
المزة	لَمَز,مَزَّة
المزدرع	NEWMORPH
المزدقان	NEWMORPH
المزدلفة	NEWMORPH
المزرفة	NEWMORPH
المزهد	NEWMORPH
المزون	NEWMORPH
المزيرعة	NEWMORPH
المزيرين	NEWMORPH
المسات	NEWMORPH
المسامعة	NEWMORPH
المستجار	NEWMORPH
المستحيرة	NEWMORPH
المستراد	مُسْتَراد
المستريون	NEWMORPH
المستشرف	مُسْتَشْرَف
المستنج	NEWMORPH
المستوى	مُسْتَوَى,مُسْتَوِي
المسجدان	مَسْجِد
المسحاء	مَسِيح
المسد	مَسَد
المسرقانان	NEWMORPH
المسعودة	مَسْعُود
المسفلة	NEWMORPH
المسلح	مُسَلِّح,مُسَلَّح
المسمارية	مِسْمارِيّ
المسناة	مُسَنّاة
المسيب	NEWMORPH
المسيلة	مُسَيِّل,مُسِيل
المشارف	مَشْرَف
المشاش	NEWMORPH
المشافر	مِشْفَر
المشترك	مُشْتَرَك,مُشْتَرِك
المشرق	مُشْرِق,مَشْرِق
المشقر	NEWMORPH
المشقق	مُشَقَّق
المشلل	NEWMORPH
المشوكة	NEWMORPH
المشيرب	NEWMORPH
المصامة	NEWMORPH
المصامدة	NEWMORPH
المصانع	مَصْنَع
المصحبية	NEWMORPH
المصران	مُصِرّ,مَصِير
المصلى	مُصَلِّي,مُصَلَّى,مَصْلِيّ
المصنعتين	مُصَنِّع,مُصَنَّع
المصيخ	NEWMORPH
المصيصة	مَصِيص
المضاجع	مُضاجِع,مَضْجَع
المضارج	NEWMORPH
المضاعة	NEWMORPH
المضبيق	NEWMORPH
المضجع	مَضْجَع,مُضَّجَع
المضل	مُضِلّ
المضمار	مِضْمار
المضياح	NEWMORPH
المضياع	NEWMORPH
المضياعة	NEWMORPH
المضيح	NEWMORPH
المضيقة	NEWMORPH
المطابخ	مَطْبَخ
المطاحل	NEWMORPH
المطارد	مُطارِد
المطافل	NEWMORPH
المطالي	NEWMORPH
المطرية	مُطْرِي
المطلع	مُطَّلَع,مُطَّلِع,مَطْلَع
المطلى	NEWMORPH
المطهر	مَطْهَر,مُطَهِّر,مُطَهَّر
المعا	أَلْمَع
المعابل	NEWMORPH
المعانيق	NEWMORPH
المعدن	مُعَدِّن,مَعْدِن
المعرس	NEWMORPH
المعرسانيات	NEWMORPH
المعرف	NEWMORPH
المعرفة	مَعْرِفَة
المعرقة	مُعْرِق,مُعَرِّق,مُعَرَّق
المعركة	مَعْرَكَة
المعشوق	مَعْشُوق
المعصب	NEWMORPH
المعلاة	مُعَلَّى,مَعْلاة
المعمل	مَعْمَل
المعمورة	مَعْمُور
المعنية	مَعْنِيّ
المعي	مِعَى,أَلْمَعِيّ,أَلْمَع,مَعْي
المعينة	مُعَيَّن,مُعِين
المعيي	أَلْمَعِيّ,مُعْيِي,مُعْيَى
المغاسل	مَغْسَل
المغرب	مَغْرِب,مُغَرَّب
المغسل	مِغْسَل,مَغْسَل
المغسلة	مَغْسَلَة,مِغْسَلَة
المغمس	NEWMORPH
المغنقة	NEWMORPH
المغيث	مُغِيث
المغيثة	NEWMORPH
المغيزل	NEWMORPH
المفترض	مُفْتَرَض
المفجر	NEWMORPH
المقاد	NEWMORPH
المقاعد	مَقْعَد
المقام	مَقام,مِقَمَّة,مُقام
المقترب	مُقْتَرِب
المقدس	مَقْدِس,مُقَدِّس,مُقَدَّس
المقدسة	مُقَدِّس,مُقَدَّس
المقر	مَقَرّ
المقرانة	NEWMORPH
المقس	NEWMORPH
المقشعر	مُقْشَعِرّ
المقطعة	مُقْطَع,مُقَطَّع,مُقْطِع
المقطم	مُقَطَّم
المقنعة	مُقَنَّع,مُقْنِع
المقياس	مِقْياس
المقيلة	NEWMORPH
المكتب	مَكْتَب
المكسر	مَكْسِر,مُكَسَّر
الملا	مُلّا
الملبط	NEWMORPH
الملة	مِلَّة,مُلَّة,مَلَّة,مَلّ
الملتزم	مُلْتَزِم,مُلْتَزَم
الملك	مَلِك,مِلْك,مُلْك
الملم	لَمْلَم,مُلِمّ
الملوحة	مُلَوِّحَة,مُلُوحَة
المليل	NEWMORPH
الممالح	مَمْلَحَة
الممدور	NEWMORPH
الممنع	NEWMORPH
الممهمى	NEWMORPH
المنارة	مَنار
المنازل	مَنْزِلَة,مَنْزِل,مُنازِل
المناشك	NEWMORPH
المناصب	مَنْصِب,مِنْصَب
المناصع	NEWMORPH
المناصف	NEWMORPH
المناظر	مُناظِر,مَنْظَر,مَنْظَرَة
المناعة	مَناعَة
المناقب	مَنْقَبَة,مَناقِب
المنتضى	NEWMORPH
المنتهب	NEWMORPH
المنتهبة	NEWMORPH
المنجشانية	NEWMORPH
المنحاة	NEWMORPH
المندى	مُنَدَّى
المنشار	مِنْشار
المنشية	NEWMORPH
المنصحية	NEWMORPH
المنصرف	مُنْصَرِف,مُنْصَرَف
المنصف	مُنَصِّف,مُنْصِف
المنصلية	NEWMORPH
المنصورة	مَنْصُور,مَنْصُورَة
المنضحية	NEWMORPH
المنطبق	NEWMORPH
المنفطرة	NEWMORPH
المنقدة	NEWMORPH
المنقدية	NEWMORPH
المنقوشية	NEWMORPH
المنقى	NEWMORPH
المنكب	مَنْكِب,مُنْكَبّ
المنكدر	NEWMORPH
المنهى	مَنْهِيّ,مُنْهِي
المنيب	مُنِيب
المنيطرة	NEWMORPH
المنيف	مُنِيف
المنيفة	مُنِيف
المهجم	NEWMORPH
المهدي	مُهْدِي,مَهْدِيّ,مُهْدَى
المهدية	مُهْدِي,مَهْدِيّ
المهراس	مِهْراس
المهزم	NEWMORPH
الموازج	NEWMORPH
المواسل	NEWMORPH
المواقر	NEWMORPH
المؤتفكة	NEWMORPH
الموثج	NEWMORPH
الموجب	مُوجِب,مُوجَب
الموشية	NEWMORPH
الموصل	مُوَصِّل,مَوْصِل
الموصلان	مُوَصِّل
الموفقي	NEWMORPH
الموفيات	NEWMORPH
الموفية	NEWMORPH
الموقعة	مُوَقَّع,مَوْقَعَة,مُوَقِّع
الموقف	مَوْقِف,مُوَقَّف
الموقق	NEWMORPH
المولة	NEWMORPH
المونسة	NEWMORPH
المونسية	NEWMORPH
المويقع	NEWMORPH
الميان	مَيّان
المياه	ماء
المئبر	مِئْبَر
الميدان	مَيْدان
الميطور	NEWMORPH
الميكعان	NEWMORPH
الميماس	NEWMORPH
المينا	آلَم,مِينا,أَلَم
النار	نار
النازية	نازِيّ
الناصرة	ناصِرَة,ناصِر
الناصرية	ناصِرِيَّة,ناصِرِيّ
الناعم	ناعِم
الناووسة	NEWMORPH
الناوية	NEWMORPH
النائع	NEWMORPH
النباء	NEWMORPH
النباج	NEWMORPH
النباريس	نِبْراس
النباع	NEWMORPH
النباوة	NEWMORPH
النبك	NEWMORPH
النبوك	NEWMORPH
النبي	نَبِيّ
النبيط	NEWMORPH
النبيطاء	NEWMORPH
النبيعة	NEWMORPH
النبيلة	نَبِيلَة,نَبِيل
النتاءة	NEWMORPH
النجارة	نِجارَة,نَجّار,نُجارَة
النجام	نَجّام
النجب	نَجْب
النجبة	نَجْب
النجد	نَجْد
النجف	نَجَف
النجفة	نَجَفَة
النجير	NEWMORPH
النجيل	نَجِيل
النجيمية	NEWMORPH
النحيزة	نَحِيزَة
النخر	نَخْر,نَخَر
النخوم	NEWMORPH
النخيل	نَخِيل,نَخْل
النخيلة	NEWMORPH
الندب	نَدَب,نَدْب
الندهة	NEWMORPH
الندوة	نَدْوَة,نُدُوَّة
الندي	نَدِيّ,نَدَى
النسار	NEWMORPH
النساسة	NEWMORPH
النسر	نَسْر
النسوخ	NEWMORPH
النسوع	NEWMORPH
النسير	NEWMORPH
النشاش	نَشّاش
النشناش	NEWMORPH
النصب	نَصْب,نُصْب,نَصَب
النصحاء	NEWMORPH
النصرية	NEWMORPH
النصع	NEWMORPH
النصيع	نَصِيع
النضارات	NEWMORPH
النضير	نَضِير
النطاق	نِطاق
النطوف	NEWMORPH
النظيم	NEWMORPH
النظيمة	NEWMORPH
النعمانية	NEWMORPH
النغل	نَغْل
النفيع	NEWMORPH
النفيعية	NEWMORPH
النفيق	NEWMORPH
النقاب	نَقّاب,نِقاب
النقار	نَقّار,نُقْرَة
النقبانة	NEWMORPH
النقر	نَقْر,نَقِر,نُقْرَة
النقرة	نَقْرَة,نَقِر,نِقْرَة,نُقْرَة
النقع	نَقْع
النقيب	نَقِيب
النقية	نَقِيّ
النقير	نَقِير
النقيرة	نَقِيرَة
النقيشة	NEWMORPH
النقيعة	NEWMORPH
النمار	NEWMORPH
النمارة	نَمّارَة
النمارق	نُمْرُق
النمرانية	NEWMORPH
النميلة	NEWMORPH
النهيب	NEWMORPH
النهيض	NEWMORPH
النوابة	NEWMORPH
النواش	NEWMORPH
النواصف	NEWMORPH
النواعص	NEWMORPH
النواقير	ناقُور
النوائح	نائِحَة
النيبطن	NEWMORPH
النير	نِير,نَيِّر
النيل	نِيل,نَيْل
الهاربية	NEWMORPH
الهاروني	NEWMORPH
الهارونية	NEWMORPH
الهاشمية	هاشِمِيّ
الهام	هامّ,هام,إِلْهام
الهامة	هامّ,هامَة,إِلْهام
الهان	إِلٰه
الهباءة	هَباء
الهباتان	NEWMORPH
الهبير	NEWMORPH
الهتاخ	NEWMORPH
الهتمة	NEWMORPH
الهتي	إِلٰه
الهتيل	NEWMORPH
الهجر	هَجْر
الهجران	NEWMORPH
الهجرة	هِجْرَة
الهجرين	NEWMORPH
الهجيرة	هَجِيرَة
الهدا	NEWMORPH
الهداة	هادِي
الهدار	هَدّار
الهدالة	NEWMORPH
الهدان	NEWMORPH
الهدبية	NEWMORPH
الهدة	هَدَّة,لَهَد-َ
الهدراء	NEWMORPH
الهدم	هَدْم
الهدملة	NEWMORPH
الهدية	هَدْيَة,هَدِيَّة
الهر	هِرّ
الهرار	NEWMORPH
الهرث	NEWMORPH
الهردة	NEWMORPH
الهرم	هَرَم,هَرِم
الهرماس	NEWMORPH
الهرمان	هَرَم,هَرِم
الهزار	هِزار
الهزاردر	NEWMORPH
الهزر	هَزْر
الهزم	هَزْم
الهزوم	NEWMORPH
الهزيم	هَزِيم
الهضيمية	NEWMORPH
الهطال	NEWMORPH
الهطالة	NEWMORPH
الهطيف	NEWMORPH
الهفة	لَهِف-َ
الهكارية	NEWMORPH
الهلية	NEWMORPH
الهم	آل,أَلْهَم,وَلِي-ِ,لَهِم-َ,هَمّ
الهماء	NEWMORPH
الهماج	NEWMORPH
الهمامية	NEWMORPH
الهمامين	هُمام,هَمّام
الهمج	هَمَج
الهنيما	NEWMORPH
الهوابج	NEWMORPH
الهواريون	NEWMORPH
الهوافي	NEWMORPH
الهور	هَوْر
الهويت	NEWMORPH
الهييما	NEWMORPH
الواحات	واحَة
الواحفان	NEWMORPH
الوادي	وادِي
الواديين	وادِي
الواقوصة	NEWMORPH
الوالجة	NEWMORPH
الوايلية	NEWMORPH
الوباءة	NEWMORPH
الوبار	NEWMORPH
الوة	أَلْوَى,آل,لَوِي-َ,أَلا,أَلْوَة,لَوَى-ِ,آلَى,لَوَّى
الوتائر	وَتِيرَة
الوتدات	NEWMORPH
الوتدة	NEWMORPH
الوتر	وَتَر,وِتْر
الوتران	وَتَر
الوتير	NEWMORPH
الوثيج	NEWMORPH
الوحاف	NEWMORPH
الوحيد	وَحِيد
الوحيدان	وَحِيد
الوحيدة	وَحِيد
الوخراء	NEWMORPH
الوداء	NEWMORPH
الوداع	وَداع
الودداء	NEWMORPH
الودكاء	NEWMORPH
الوديان	وادِي,وُدِّيّ
الوديك	وَدِيك
الوذ	لاذ
الورادة	NEWMORPH
الوراق	وَرّاق
الوراقين	وَرّاق
الورد	وَرْد,وِرْد
الوردانية	NEWMORPH
الوردية	وَرْدِيَّة,وَرْدِيّ
الورقة	وَرَق
الوركاء	NEWMORPH
الوركة	NEWMORPH
الورلة	NEWMORPH
الوريعة	NEWMORPH
الوزان	وِزان
الوزوازة	NEWMORPH
الوزيرة	وَزِير
الوزيرية	NEWMORPH
الوس	لاس
الوسائد	وِسادَة
الوسباء	NEWMORPH
الوسة	لاس
الوشاءة	NEWMORPH
الوشل	وَشَل
الوشم	وَشْم
الوشيجة	وَشِيج,وَشِيجَة
الوشيع	وَشِيع
الوصيد	وَصِيد
الوصيق	NEWMORPH
الوضاحية	NEWMORPH
الوضح	وَضَح
الوضيعة	وَضِيع,وَضِيعَة
الوطيح	NEWMORPH
الوعر	وَعْر
الوعساء	NEWMORPH
الوعلتين	NEWMORPH
الوعواع	NEWMORPH
الوعوعة	وَعْوَعَة
الوعيرة	وَعِير
الوفاء	وَفاء
الوقاصية	NEWMORPH
الوقباء	NEWMORPH
الوقبى	NEWMORPH
الوقواق	وَقْواق
الوقيط	NEWMORPH
الوكف	وَكْف
الوكيع	NEWMORPH
الولجة	NEWMORPH
الولية	وَلِيَّة
الوليهة	NEWMORPH
الومة	لَوَّم,لام
الونية	NEWMORPH
اليابس	يابِس
الياج	NEWMORPH
الياروقية	NEWMORPH
الياسرية	NEWMORPH
الية	آلِيّ,إِلَى,آلِيَّة,وَلِي-ِ,أَلْيَة
اليتائم	NEWMORPH
اليتيمة	يَتِيم
اليدملة	NEWMORPH
اليزيدية	يَزِيدِيّ
اليس	لَيِس-َ,لَيْسَ,أَلْيَس
اليستغور	NEWMORPH
اليش	NEWMORPH
اليعمرية	NEWMORPH
اليعملة	NEWMORPH
اليفاع	يَفاع
اليفة	أَلِيف,لَيَّف
اليقاع	NEWMORPH
اليل	NEWMORPH
اليمامة	يَمام
اليمن	يَمَن,يُمْن
اليمينين	يَمِين
الين	يِن,لَيَّن,آلَى,أَلْيَن,أَلان
اليهودية	يَهُودِيّ,يَهُودِيَّة
اليون	آلِيّ
ام	آم-ِ,إِم,أَم,أُمّ
امج	مَجّ,ماج
امد	أَمْدَى,مَدّ,ماد-ِ,أَمْبِير,أَمَدّ
امدان	NEWMORPH
امديزة	NEWMORPH
امر	مار,أَمْر,مار-ِ,أَمَّر,أَمَرّ,مَرّ,أَمار,آمَر,آمِر,أَمَر
امرة	أَمْر,مار,مار-ِ,أَمَّر,أَمَرّ,مَرّ,أَمار,آمَر,إِمْرَة,أَمَر,آمِر
امعط	أَمْعَط,مَعَط-َ
امغيشيا	NEWMORPH
امل	مَلَّى,أَمَل-َ,مَلّ-َ,آمِل,أَمْلَى,أَمال,أَمَلّ,أَمَّل,مال-ِ,أَمَل,مَلا
املط	مَلَّط,أَمْلَط,مَلَط
امن	مَنَى-ِ,مَنّ,مَنا,أَمَنّ,آمَن,أَمْن,أَمِن-َ,أَمَّن,آمِن,مَنَّى
امهار	مُهْر
امو	NEWMORPH
امواش	NEWMORPH
امويه	أُمَوِيّ
اميل	أَمال,أَمْيَل,مال-ِ,إِمِيل,مَيَّل
انا	آنا,إِنَّ,آن,أَنا,أَنّ-ِ,أَنَّ
اناخة	أَناخ
انار	أَنار
اناس	إِنْسان,إِنْس
انب	ناب,نَبا,أَنَبَة,أَناب,أَنَّب
انبابة	NEWMORPH
انبامة	NEWMORPH
انبردوان	NEWMORPH
انبط	نَبَّط,نَبَط,أَنْبَط
انبطة	نَبَّط,نَبَط,أَنْبَط
انبل	أَنْبَل,نَبُل,نَبَل
انبلونة	NEWMORPH
انبير	NEWMORPH
انتان	أَنَّة
انتقيرة	NEWMORPH
انج	نَجَّى,أَنْجَى,نَجا
انجافرين	NEWMORPH
انجل	نَجَل,ٱِنْجَلَى,أَنْجَل
انحاص	ٱِنْحاص
انحل	أَنْحَل,نَحَل-َ,نَحِل-َ,ٱِنْحَلّ,نَحُل,نَحَل-َُ
انخل	نَخَل,أَنْخِيل
انداق	NEWMORPH
اندامش	NEWMORPH
اندان	NEWMORPH
اندة	نَدَه-َ,نَدِي-َ,نَدَّى,نَدا,أَنْدَى,نَدّ-ِ,ناد
اندجن	NEWMORPH
اندخوذ	NEWMORPH
انددي	NEWMORPH
اندراب	NEWMORPH
اندرابة	NEWMORPH
اندراش	NEWMORPH
اندرين	أَنْدَر
اندزهل	NEWMORPH
اندس	ٱِنْدَسّ,نَدَس,ٱِنْداس
اندغن	NEWMORPH
اندق	ٱِنْدَقّ
اندكان	NEWMORPH
اندوان	NEWMORPH
اندوشر	NEWMORPH
انساباذ	NEWMORPH
انسان	إِنْسان
انشاج	NEWMORPH
انشاق	NEWMORPH
انشام	NEWMORPH
انشميثن	NEWMORPH
انصاب	نَصْب,نُصْب,نَصَب
انصنا	ناص,نَصّ
انطابلس	NEWMORPH
انطاق	NEWMORPH
انطاكية	أَنْطاكِيّ,أَنْطاكِيَّة
انطالية	NEWMORPH
انطرطوس	NEWMORPH
انطليش	NEWMORPH
انف	نَفَى,نَفا,أَنِف-َ,ناف,أَنُوف,أَناف,أَنْف,آنِف,نَفّ-ِ
انفة	نَفَى,نَفا,أَنِف-َ,أَنَفَة,أَناف,أَنُوف,ناف,أَنْف,آنِف,نَفّ-ِ
انقد	أَنْقَد,ٱِنْقاد,نَقَد,ٱِنْقَدّ
انقرة	نَقَّر,نَقَر,أَنْقَرَة
انقلقان	NEWMORPH
انكاد	نَكْد,نَكِد
انكجان	NEWMORPH
انكفردر	NEWMORPH
انور	أَنْوَر,نَوَّر
انى	إِنَّ,وَنَى-ِ,آن,آنِيّ,أَنَّ,أَنَّى,أَنَى,أَنَى-ِ
اني	إِنَّ,وَنَى-ِ,آن,آنِيّ,أَنَّ,أَنَّى,أَنَى-ِ,أَنَى
انيسون	أَنِيسُون,أَنِيس
اهاب	هاب-َ,أَهاب,إِهاب
اهالة	أَهال
اهجم	هَجَم,أَهْجَم,هَجَّم
اهر	هار,هَرا,وَهَر-ِ,هَرّ-ِ
اهريت	NEWMORPH
اهريج	NEWMORPH
اهلم	هَلَّم
اهناس	NEWMORPH
اهوى	هَوَّى,هَوَى-ِ,هَوِي-َ,أَهْوَى
اوارة	وارَى,أُوار
اواق	أُوقِيَّة
اوال	والَى
اوان	أَوان,إِناء
اوانا	أَوَى-ِ,أَوان,آوَى,أَوَّى
اوائن	NEWMORPH
اوب	أَوَّب,أَوْب
اوبر	أَوْبَر,وَبِر-َ
اوبه	وَبَه-َ,أَوَّب,أَوْبَه,أَوْب,أَوْبَة
اوثنان	NEWMORPH
اوج	أَوْج
اوجار	وَجْر
اوجلة	أَوْجَل
اوجلى	NEWMORPH
اود	وَدّ-َ,أَوِد-َ,أَوَّد,أَوْدَى,أَوَد
اودن	أَوِد-َ,أَوَّد
اودنة	أَوَّد
اوذ	NEWMORPH
اوذغست	NEWMORPH
اور	أُور,أَوْرَى,وَرَّى
اوراس	أَوْراس
اورال	وَرَل
اوربة	وَرَّب,أَوْرَب
اورفي	NEWMORPH
اورل	NEWMORPH
اورم	وَرَّم,أَوْرَم
اوريشلم	NEWMORPH
اوريط	NEWMORPH
اورين	أَوْرَى
اوريولة	NEWMORPH
اوزكند	NEWMORPH
اوس	أَوْسَى,أَوْس
اوش	وَشَّى
اوعال	وَعْل
اوق	أَوَّق
اوقانيه	NEWMORPH
اوقح	وَقُح,وَقِح-َ
اوقضى	NEWMORPH
اوقع	أَوْقَع,وَقَّع,وُقِّع
اوقيانوس	NEWMORPH
اول	وَلَّى,أَوَّل,أَوْلَى,أُول
اولاس	NEWMORPH
اولب	NEWMORPH
اوليل	NEWMORPH
اومة	أُوم
اون	أَوْن,وَنَّى,وَنِي-َ,وَنّ-ِ
اونبة	NEWMORPH
اونيك	وَنَّى
اوه	أَوَّه,وَهِي-َ,أَوْهَى
اويش	NEWMORPH
اياء	NEWMORPH
اياير	NEWMORPH
ايبسن	أَيْبَس
اية	أَيّ,إِيه,آيَة
ايج	NEWMORPH
ايجلن	NEWMORPH
ايجلي	NEWMORPH
ايجلين	NEWMORPH
ايد	أَيَّد,يَد
ايدم	NEWMORPH
ايذج	NEWMORPH
ايذوج	NEWMORPH
اير	إِير
ايرام	NEWMORPH
ايران	إِيران
ايراهستان	NEWMORPH
ايراياذ	NEWMORPH
ايرج	NEWMORPH
ايغان	NEWMORPH
ايك	أَيّ,أَيْكَة
ايل	آيِل,إِيل,أَيِّل
ايلاق	NEWMORPH
ايلان	آيِل,أَيِّل
ايلة	آيِل,أَيِّل
ايلياء	NEWMORPH
اين	أَيْنَ,أَيَّن
ايناون	NEWMORPH
ايهات	NEWMORPH
ايهب	NEWMORPH
ايهم	أَيّ
ايوب	أَيُّوب
باب	آب,أَب,باب,إِبّ
بابان	إِبّان,باب
بابرت	NEWMORPH
بابرتي	إِبْرَة
بابسير	NEWMORPH
بابش	NEWMORPH
بابشير	أَبْشِير
بابغيش	NEWMORPH
بابقران	NEWMORPH
بابل	إِبْل,بابِل
بابلا	بابِل
بابليون	بابِلِيّ
بابه	بابِه,آب,باب,آبِه,أَبَه
بابونيا	NEWMORPH
بابين	أَبْيَن,باب,آبِي
باتكرو	NEWMORPH
باجاخسرو	NEWMORPH
باجبارة	إِجْبار
باجة	باجَه
باجخوست	NEWMORPH
باجدا	NEWMORPH
باجرا	NEWMORPH
باجربق	NEWMORPH
باجرما	NEWMORPH
باجرمق	NEWMORPH
باجروان	NEWMORPH
باجسري	جِسْر
باجميري	NEWMORPH
باجنيس	NEWMORPH
باجوا	NEWMORPH
باحسيثا	NEWMORPH
باحمشا	NEWMORPH
باخة	باخ
باخديدا	NEWMORPH
باخرز	NEWMORPH
باخمرا	NEWMORPH
باخوخا	NEWMORPH
باداما	NEWMORPH
بادران	دَرَن
بادرايا	NEWMORPH
بادس	NEWMORPH
بادن	بادِن
بادوريا	NEWMORPH
بادولي	NEWMORPH
باذ	باذّ
باذبين	NEWMORPH
باذغيس	NEWMORPH
باذن	إِذْن,آذِن,أُذُن
باذورد	NEWMORPH
بار	بارّ,بار,آر
باراب	آراب,إِرْب
باران	بارّ
بارجاخ	NEWMORPH
بارجان	NEWMORPH
بارديزه	NEWMORPH
بارسكث	NEWMORPH
بارق	آرِق,أَرِق,أَرَق,أَرَقّ,بارِق
باركث	NEWMORPH
بارما	بارْما
بارناباذ	NEWMORPH
بارنبار	NEWMORPH
بارنجان	NEWMORPH
باروا	بار,بارَى
باروذ	NEWMORPH
باروس	NEWMORPH
باروسما	NEWMORPH
باروشة	أَرْش
باري	بارِي,آري,بارّ,أَري,آرِيّ,آر,بارَى
بارين	بارّ,بارَى
باز	بازِي,أَزّ,باز
بازبدى	NEWMORPH
بازة	باز,أَزّ
بازفت	NEWMORPH
بازكل	NEWMORPH
بازكند	NEWMORPH
بازوغى	NEWMORPH
باسبيان	NEWMORPH
باسلامة	إِسْلام
باسند	NEWMORPH
باسورين	NEWMORPH
باسيان	أَسْيان
باسين	أُسّ,آسِي,آس
باشان	باشان,باشّ
باشتان	باشّ
باشر	أَشِر,باشَر,أَشَر
باشزى	NEWMORPH
باشغرد	NEWMORPH
باشك	باش,باشِك,باشّ,باشَك
باشمنايا	NEWMORPH
باشو	باشّ
باشيا	NEWMORPH
باشينان	NEWMORPH
باصر	إِصْر,باصِر
باصفرا	NEWMORPH
باصلوخان	NEWMORPH
باضع	باضَع
باطرقان	NEWMORPH
باطرنجى	NEWMORPH
باعث	باعِث
باعجة	NEWMORPH
باعذرا	NEWMORPH
باعربايا	NEWMORPH
باعشيقا	NEWMORPH
باعقوبا	NEWMORPH
باعيناثا	NEWMORPH
باغ	باغِي
باغاية	NEWMORPH
باغة	باغَة
باغز	NEWMORPH
باغش	NEWMORPH
باغك	NEWMORPH
باغناباذ	NEWMORPH
باغند	NEWMORPH
باغون	باغِي
باف	إِف
بافخاري	NEWMORPH
بافد	NEWMORPH
بافكى	إِفْك,أَفْك
باقدارى	قَدْر,قَدَر
باقدرا	NEWMORPH
باقرحا	NEWMORPH
باقردى	NEWMORPH
باقسياثا	NEWMORPH
باقطايا	NEWMORPH
باقطنايا	NEWMORPH
باكة	NEWMORPH
باكسايا	NEWMORPH
باكلبا	NEWMORPH
باكويه	NEWMORPH
بالا	بال,أَلّا
بالبونت	NEWMORPH
بالة	آل,بالَة,إِلٰه,بال,آلَة
بالس	NEWMORPH
بالعة	NEWMORPH
بالقان	NEWMORPH
بالك	آل,بال
بالو	أُلُو,بالِي
بالوان	لَوْن,أَلْوان
بالوجوزجان	NEWMORPH
بالوز	وَزّ,وَزَّة
باماورد	NEWMORPH
بامردنى	NEWMORPH
بامردي	أَمْرَد
بامنج	NEWMORPH
بامهر	NEWMORPH
باميان	NEWMORPH
بامئين	NEWMORPH
بان	آن,بانِي,بِأَنَّ,بِأَن,بان-ِ
باناس	إِنْسان,إِنْس
بانب	أَنَبَة
بانبورا	NEWMORPH
بانقوسا	NEWMORPH
بانقيا	NEWMORPH
بانك	آنُك,آن,بِأَنَّ
بانوب	NEWMORPH
باوجان	NEWMORPH
باور	أُور,باوِر
باورد	NEWMORPH
باوشنايا	NEWMORPH
باول	أَوَّل,باوِل,أُول
بايات	باي,آيَة
بايان	أَيان,إِيان,باي
ببا	NEWMORPH
ببة	NEWMORPH
ببرذعة	بَرْذَعَة
ببز	بُزّ,بَزّ
ببشتر	NEWMORPH
ببشى	NEWMORPH
ببق	بَقّ
ببليون	بِلْيُون
ببمبم	NEWMORPH
ببنة	بُنّ
ببيج	NEWMORPH
بتا	بَتّ
بتان	NEWMORPH
بتخذان	NEWMORPH
بتر	أَبْتَر,بَتَر,بَتْر
بتران	تران
بترير	NEWMORPH
بتسابور	NEWMORPH
بتعة	NEWMORPH
بتمار	NEWMORPH
بتنين	تَنِّين,تِنِّين
بتيل	NEWMORPH
بتيلة	NEWMORPH
بتينق	NEWMORPH
بثرون	NEWMORPH
بثينة	بُثَيْنَة
بجان	جانِي,جان
بجانة	NEWMORPH
بجاوة	جاوَه
بجاية	NEWMORPH
بجة	NEWMORPH
بجدان	NEWMORPH
بجستان	NEWMORPH
بجمزا	NEWMORPH
بجوار	جارِيَة,جِوار
بحار	حارّ,بَحّار,بَحْر
بحت	بَحّ,بَحْت,باح
بحتر	بُحْتُر,حُتُر,حِتار
بحثر	بَحْثَر
بحراباذ	NEWMORPH
بحران	حَرّان,بَحْر,بُحْران
بحرة	حُرّ,حَرَّة,بَحْر,حَرّ,بَحَّر,بَحْرَة
بحطيط	NEWMORPH
بحير	حَيْر
بحيراباذ	NEWMORPH
بخارى	بُخار,بُخارِيّ
بخجرميان	NEWMORPH
بدا	بَدا,بُدّ,بَدّ
بداكر	NEWMORPH
بدالة	دالّ,دال,دالَّة,بَدّالَة,بَدّال
بدبد	NEWMORPH
بدخكث	NEWMORPH
بدر	بَدْر,بَدَر,دَرّ,دُرّ
بدس	NEWMORPH
بدلان	NEWMORPH
بدليس	NEWMORPH
بدن	بَدُن,باد-ِ,بَدِين,بَدَن
بدهة	بَدَه-َ
بدوة	بَدَوِيّ,بَدا,بَدّ
بدوتان	NEWMORPH
بديانا	دِيانا
بديع	بَدِيع
بدين	دِين,دَيِّن,دَيْن,بَدِين
بذ	بَذّ
بذان	NEWMORPH
بذخش	NEWMORPH
بذخشان	NEWMORPH
بذر	بَذَّر,بَذْر,بَذَر,ذَرّ
بذش	NEWMORPH
بذقون	ذَقْن
بذندون	NEWMORPH
بذيخون	NEWMORPH
بذيس	NEWMORPH
براءان	NEWMORPH
براثا	NEWMORPH
برارجان	NEWMORPH
براش	بَراش
براعيم	بُرْعُوم
براغيل	NEWMORPH
براق	بَرّاق,بُراق,راقِي,راق
براقة	بَرّاق,راق
براقش	بِرْقِش
براكد	راكِد
برام	رامِي,بُرْمَة,رام
بران	NEWMORPH
براهان	NEWMORPH
براوستان	NEWMORPH
برباط	رِباط
بربخ	بَرْبَخ
بربرة	بَرْبَر,بَرْبَرِيّ
بربروس	NEWMORPH
بربسما	NEWMORPH
بربشتر	NEWMORPH
بربطانية	NEWMORPH
بربعيص	NEWMORPH
بربغ	NEWMORPH
بربيطياء	NEWMORPH
برت	بَرّ-ِ,بَرَى-ِ,بار,رُتّ
برث	رَثّ
برثان	NEWMORPH
برثة	رِثَّة,رَثّ
برثم	NEWMORPH
برج	رَجّ,بُرْج
برجان	بُرْج
برجة	رَجّ,رَجَّة,بُرْج
برجد	NEWMORPH
برجلان	بَرْجَل
برجمة	بُرْجُمَة,رُجْمَة,رَجْم
برجمين	NEWMORPH
برجونية	NEWMORPH
برحايا	NEWMORPH
برخشان	NEWMORPH
برخو	رَخْو
برخوار	NEWMORPH
برد	بُرْد,بَرَد,بَرَّد,رَدّ,بَرُد,بَرْد
برداد	NEWMORPH
بردرايا	NEWMORPH
بردسير	NEWMORPH
بردنيس	NEWMORPH
بردون	NEWMORPH
بردى	بَرَدَى,بَرْدِيّ,بُرْد,بَرَد,رَدَى,رَدّ,بَرْد
برديا	بَرْدِيّ
برديج	NEWMORPH
برديس	بَرْدِيس
برذاور	NEWMORPH
برذعة	بَرْذَعَة
برذون	بِرْذَوْن
برذيش	NEWMORPH
برز	رُزّ,بَرَّز,بَرَز,بَرُز
برزاباذان	NEWMORPH
برزاط	NEWMORPH
برزبين	NEWMORPH
برزة	رَزَّة,رُزّ,بَرَّز,بَرَز,بَرُز
برزماهن	NEWMORPH
برزمهران	NEWMORPH
برزن	بَرَّز,بَرَز,بَرُز
برزنج	NEWMORPH
برزند	NEWMORPH
برزه	رَزَّة,رُزّ,بَرَّز,بَرَز,بَرُز
برزويه	NEWMORPH
برس	برِس
برسان	NEWMORPH
برسانجرد	NEWMORPH
برسحور	NEWMORPH
برسخان	NEWMORPH
برسف	رَسْف
برسيم	بِرْسِيم
برشاعة	NEWMORPH
برشانة	بُرْشام
برشليانة	NEWMORPH
برشهر	NEWMORPH
برطاس	NEWMORPH
برطلى	رَطْل
برطوبة	رُطُوبَة
برع	بَرُع,بَرَع-َ
برعة	بَرُع,بَرَع-َ
برعش	NEWMORPH
برغث	NEWMORPH
برغر	بَرْغَر
برغوث	بَرْغُوث,رَغُوث
برفشخ	NEWMORPH
برق	رَقّ,رِقّ,بَرْق,بَرَق
برقاء	رَقّاء
برقان	بَرْق
برقة	رَقّ,رِقّ,بَرْق,رِقَّة,بَرَق,بَرْقَة
برقتان	NEWMORPH
برقعيد	NEWMORPH
برقولش	NEWMORPH
برك	بِرْكَة,بَرّ,بِرّ,بُرّ,بَرَك,بَرَّك
بركاوان	NEWMORPH
بركد	NEWMORPH
بركوت	NEWMORPH
برلس	NEWMORPH
برم	بُرْمَة,بَرِم-َ,بَرِم,بَرَّم,رَمّ,بَرَم
برماقان	NEWMORPH
برمة	بُرْمَة,بَرِم,بَرَّم,رَمّ,رِمَّة,رُمَّة,بَرَم
برمس	رَمْس
برملاحة	NEWMORPH
برمنش	NEWMORPH
برنان	رَنّان
برندق	NEWMORPH
برنوذ	NEWMORPH
برنوه	رُنُوّ,رَنْوَة
برنيق	NEWMORPH
برنيل	NEWMORPH
برهوت	NEWMORPH
بروج	رُوج,برُوج,بُرْج
بروجرد	NEWMORPH
بروقان	NEWMORPH
بروقة	رَوْق,رُوقَة,بُرُوق
برونجرد	NEWMORPH
برونداس	NEWMORPH
برونس	NEWMORPH
برووقتان	NEWMORPH
بريانة	رِيان,رَيّان
بريث	NEWMORPH
بريدة	رَوْد,بُرَيْدَة,بَرِيد
بريش	رِيش
بريشو	NEWMORPH
بريك	بَرِّيّ,رَيّ
بريل	NEWMORPH
بريم	بَرِيم,رِئْم,رِيم
بريه	بَرِيَّة,رِئَة,بَرِّيَّة,بَرِّيّ,رَيّ
بزاخة	NEWMORPH
بزار	بَزّار
بزاعة	NEWMORPH
بزاق	بُزاق
بزان	بُزّ,زانِي,زان
بزانة	زانَة,زان
بزدان	NEWMORPH
بزدة	NEWMORPH
بزديغرة	NEWMORPH
بزرة	بَزَّر,بِزْر,بَزَر-ِ,زِرّ
بزرجسابور	NEWMORPH
بزغام	NEWMORPH
بزقباذ	NEWMORPH
بزكوار	NEWMORPH
بزليانة	NEWMORPH
بزماقان	NEWMORPH
بزنر	NEWMORPH
بزنيروذ	NEWMORPH
بزوغى	بُزُوغ
بزوفر	NEWMORPH
بزي	زِيّ,بُزّ,بَزّ
بزيان	زِيان,زَيان
بزيذي	NEWMORPH
بزيقيا	NEWMORPH
بس	بَسّ
بسا	بَسّ
بساء	NEWMORPH
بساسة	بَسَّة,سِياسِيّ
بساق	ساقِي,ساق
بسان	سان
بسبة	سَبّ,سُبَّة,سَبَّة,سَبَه
بسبط	سِبْط,سَبِط
بست	باس,سِتّ,بَسّ
بسترة	بَسْتَر,بَسْتَرَة,سُتْرَة,سِتْر,سِتار
بستيغ	NEWMORPH
بسر	بَسَر,سُرّ,بُسْر,سِرّ
بسرفوث	NEWMORPH
بسطام	سِطام
بسطة	بَسْط,بَسْطَة,بَسَّط,بَسَط,بِساط
بسفرجان	NEWMORPH
بسكاس	NEWMORPH
بسكاير	سِيكارَة
بسكرة	سَكْرَة,سُكْر,سُكَّر
بسل	سَلّ,بَسُل,سِلّ
بسلة	بِزِلَّة,سَلّ,سَلَّة,سِلّ
بسوسا	NEWMORPH
بسومة	NEWMORPH
بسوى	سَوِيّ,سِوَى
بسي	سِي
بسيان	سِيان
بشاءة	NEWMORPH
بشار	بَشّار,شارِي
بشام	شام
بشان	NEWMORPH
بشائم	NEWMORPH
بشبراط	NEWMORPH
بشبق	شُبُق,شَبِق,شَبَق
بشت	باش,شَتّ,بَشّ-َ,بُشْت
بشتان	شَتّان
بشترى	NEWMORPH
بشتن	باش
بشتنفروش	NEWMORPH
بشتنقان	NEWMORPH
بشتير	NEWMORPH
بشرى	شِرَى,بُشْر,بُشْرَى,شَرّ,بِشْر,بَشَرِيّ,شَرْي,بَشَر,بُشْرَة
بشكان	NEWMORPH
بشكلار	NEWMORPH
بشلاو	NEWMORPH
بشم	بَشَم,بَشِم-َ,شَمّ
بشمى	بَشَم,شَمِّيّ,شَمّ
بشنى	شَنّ
بشواذق	NEWMORPH
بشيت	شِيت
بشير	شِير,بَشِير
بشيلة	شَيْلَة
بصاق	بُصاق
بصرى	بَصْرِيّ,بَصَرِيّ,بَصَر
بصنا	بَصّ-ِ,بَصّ
بصيدا	صَيْداء
بضاعة	بِضاعَة
بضة	بَضّ-ِ,بَضّ
بطحاء	أَبْطَح
بطحان	طَحّان
بطروح	طَرُوح
بطروش	طَرْش
بطلس	طَلْس,طِلْس
بطليوس	بَطَلْيَوْس
بطنان	طَنّان,بَطْن
بطياس	NEWMORPH
بعاث	NEWMORPH
بعانيق	NEWMORPH
بعدان	بُعْد
بعرين	عَرِين
بعطان	NEWMORPH
بعق	بَعَق,عَقّ
بعقوبا	NEWMORPH
بعل	بَعْل
بغاث	بُغاث
بغانخذ	NEWMORPH
بغاوزجان	NEWMORPH
بغث	غَثّ
بغداد	بَغْداد
بغدخزرقند	NEWMORPH
بغدل	NEWMORPH
بغراس	غِراس,غَرْس
بغروند	NEWMORPH
بغشور	NEWMORPH
بغلان	بَغْل
بغوخك	NEWMORPH
بغولن	NEWMORPH
بغيبغة	NEWMORPH
بغية	غَيّ,بَغْي,بَغِيّ,غَيَّة,بُغْيَة
بغيث	غَيْث
بغيديد	NEWMORPH
بقابوس	قابُوس
بقار	قارِي,قار,قارّ,بَقّار
بقدس	قُدْس,قُدُس
بقر	قَرّ,بَقَر
بقران	قِران
بقرة	قَرّ,قِرَّة,بَقَر,قُرَّة
بقطاطس	NEWMORPH
بقطر	قَطَر,قُطْر,قَطْر,قِطار
بقع	بَقَّع,بُقْعَة
بقعاء	NEWMORPH
بقعان	NEWMORPH
بقلار	NEWMORPH
بقلان	NEWMORPH
بقنس	NEWMORPH
بقيرة	قِير
بقيع	NEWMORPH
بقيقا	NEWMORPH
بكاس	كاس
بكة	بَك,بَكَّة
بكر	بَكَر,بِكْر,كَرّ,بَكَّر,بَكْر,بَكْرَة
بكراباذ	NEWMORPH
بكرد	كُرْدِيّ
بكمزة	NEWMORPH
بكيل	كَيْل
بكيون	NEWMORPH
بلاباذ	NEWMORPH
بلاس	بلاس
بلاسكرد	NEWMORPH
بلاشجرد	NEWMORPH
بلاص	بَلّاص
بلاطة	بَلاط,بَلاطَة
بلاطنس	NEWMORPH
بلاق	NEWMORPH
بلاكث	NEWMORPH
بلبد	لِبْدَة,لُبَد,لِبْد,لَبِد,لَبَد
بلبل	بُلْبُل,بَلْبَل
بلبول	NEWMORPH
بلبيس	لَبِيس
بلج	بَلِج-َ,بَلَج,لُجّ
بلجان	لَجْنَة
بلخ	NEWMORPH
بلخاب	NEWMORPH
بلخان	NEWMORPH
بلخع	NEWMORPH
بلد	بَلُد,أَلَدّ,بَلَّد,لِدّ,بَلَد
بلدة	لِدَة,أَلَدّ,بَلَّد,لِدّ,بَلْدَة,بَلَد
بلدح	NEWMORPH
بلدود	لَدُود
بلرم	NEWMORPH
بلس	NEWMORPH
بلش	NEWMORPH
بلشكر	NEWMORPH
بلشيج	NEWMORPH
بلط	بَلَّط,بَلْطَة
بلطش	لَطْش
بلع	بَلَّع,بَلَع-َ,بَلْع,بَلِع-َ
بلغار	بُلْغار
بلغي	بُلْغَة
بلق	NEWMORPH
بلقينة	NEWMORPH
بلكرمانية	NEWMORPH
بلكيان	NEWMORPH
بلنجر	NEWMORPH
بلنسية	بَلَنْسِيَة
بلنوبة	NEWMORPH
بلنياس	NEWMORPH
بلهيب	لَهِيب
بلو	NEWMORPH
بلوقة	NEWMORPH
بلومية	NEWMORPH
بلي	بَلّ,لَيّ,بِلَى,بِلِّي,بَلَى,بَلِي-َ,بِلّ,لِي,بَلِيّ
بليان	NEWMORPH
بلية	بَلِيَّة,لَيّ,بِلِّي,بَلِي-َ,لَيَّة,بَلِيّ
بليرة	لِيرَة
بليق	لَيْق,لِيقَة
بليل	لَيْل,بَلِيل
بلينا	لَيّ,لِينا,بِلِّي,بَلِيَنا,بَلِي-َ,بَلِيّ
بليونش	NEWMORPH
بم	بِمَ
بمارش	NEWMORPH
بمجكث	NEWMORPH
بملان	NEWMORPH
بنا	بُنّ,بَنّاء,بِ,بان-ِ
بنارق	NEWMORPH
بناكت	NEWMORPH
بنان	بَنان
بنانة	بَنان
بنبميرة	NEWMORPH
بنة	بُنّ
بنجخين	NEWMORPH
بنجهير	NEWMORPH
بنجيكت	NEWMORPH
بندجان	NEWMORPH
بندسيان	NEWMORPH
بندكان	NEWMORPH
بنديمش	NEWMORPH
بنزرت	NEWMORPH
بنسارقان	NEWMORPH
بنطس	نَطْس,نَطاسِيّ
بنفزوة	NEWMORPH
بنكت	نُكْتَة
بنكث	نَكْث
بننور	NEWMORPH
بنها	بُنّ,بَنْها
بني	بُنّ,بِنْيَة,بَنَى-ِ,بَنِي,بِن,نَيّ,نِيّ,بُنَيّ
بنيان	بُنْيان
بنيرقان	NEWMORPH
به	بِ
بهاباذ	NEWMORPH
بهار	هارِي,بَهار
بهاران	NEWMORPH
بهارزة	NEWMORPH
بهاطية	NEWMORPH
بهائم	بَهِيمَة,هائِم
بهجورة	NEWMORPH
بهداذين	NEWMORPH
بهدى	هَدْي,هُدَى,هَدّ
بهرة	بَهَر-َ,بَهْرَة,هِرَّة,بَهْر,هِرّ,بُهْرَة,بُهْر
بهرزان	NEWMORPH
بهرسير	NEWMORPH
بهزان	NEWMORPH
بهستان	NEWMORPH
بهستون	NEWMORPH
بهسنا	هَسّ
بهقباذ	NEWMORPH
بهلا	بَهَل-َ,باهِل
بهلكجين	NEWMORPH
بهندف	NEWMORPH
بهونة	هُون,هَوْن
بواء	NEWMORPH
بوادر	بادِرَة
بوار	بَوار
بوازن	وازِن
بوازنة	وازِن
بواط	باطِيَة,واط,واطِي,بُواط
بواعة	NEWMORPH
بوان	NEWMORPH
بوانة	NEWMORPH
بوته	NEWMORPH
بوتيج	NEWMORPH
بورنمذ	NEWMORPH
بوزجان	NEWMORPH
بوزع	NEWMORPH
بوزن	وَزْن,بَوَّز
بوزنجرد	NEWMORPH
بوزوز	NEWMORPH
بوس	NEWMORPH
بوسنج	NEWMORPH
بوش	بَوَّش,بَوْش,بُوش
بوشان	NEWMORPH
بوشنج	NEWMORPH
بوص	بُوص
بوصان	NEWMORPH
بوصرا	NEWMORPH
بوصلابا	NEWMORPH
بوصير	NEWMORPH
بوظة	بُوظَة
بوق	بَوَّق,بُوق
بوقاس	NEWMORPH
بوقان	NEWMORPH
بوقة	بَوَّق,بُوق,وُقَّة
بولان	NEWMORPH
بولة	بُول,بَوَّل,بَوْل,وَلَه
بون	بَون,وَنّ
بونا	بَون
بونة	بَون,وَنّ
بونفاط	NEWMORPH
بوهرز	NEWMORPH
بويط	NEWMORPH
بوينة	NEWMORPH
بيار	بِيار
بياس	NEWMORPH
بياسة	NEWMORPH
بيان	بَيان,يان
بيانة	بَيان
بيبرز	NEWMORPH
بيج	NEWMORPH
بيجان	بِيجان
بيجانين	NEWMORPH
بيد	بِيد,يَد,بَيْدَ
بيدان	NEWMORPH
بيدح	NEWMORPH
بيدرة	بَيْدَر
بيران	NEWMORPH
بيرة	بِيرَة,بِيرا
بيرجند	NEWMORPH
بيرحا	NEWMORPH
بيرمس	NEWMORPH
بيروت	بَيْرُوت
بيروذ	NEWMORPH
بيروزكوه	NEWMORPH
بيرين	NEWMORPH
بيزان	باز
بيزع	NEWMORPH
بيس	NEWMORPH
بيسان	NEWMORPH
بيست	NEWMORPH
بيستي	بَيْسَة
بيسكند	NEWMORPH
بيش	NEWMORPH
بيشة	NEWMORPH
بيشك	NEWMORPH
بيض	بِيض,بَيَّض,بَيْض
بيضان	NEWMORPH
بيضة	بَيْضَة,بِيض,بَيَّض,بَيْض
بيطرة	بَيْطَر,بَيْطَرَة
بيغو	NEWMORPH
بيقر	NEWMORPH
بيكند	NEWMORPH
بيكنده	NEWMORPH
بيل	بِيل
بيلقان	NEWMORPH
بيلمان	NEWMORPH
بيما	NEWMORPH
بيمان	NEWMORPH
بيمند	NEWMORPH
بينة	يِن,بَيِّنَة,بَيَّن,بَيْنَ,بَيِّن
بينون	بِينُون
بينونة	NEWMORPH
بيهق	NEWMORPH
بيوار	NEWMORPH
بيوزنبارة	NEWMORPH
بيوقان	NEWMORPH
بيويط	NEWMORPH
تاجرة	أَجَر,تاجَر,تاجِر
تاجرفت	NEWMORPH
تاجنة	NEWMORPH
تاجونس	NEWMORPH
تادلة	NEWMORPH
تادن	NEWMORPH
تاديزة	NEWMORPH
تاذف	NEWMORPH
تاراء	NEWMORPH
تاران	NEWMORPH
تارم	أَرَم-ِ
تاسن	أَسِن-َ
تاكرنى	NEWMORPH
تاكرونة	أَكَر-ِ
تاكيان	NEWMORPH
تاكيس	تاكِيس
تالشان	NEWMORPH
تامدفوس	NEWMORPH
تامدلت	NEWMORPH
تامرا	أَمَر
تامركيدا	NEWMORPH
تامست	NEWMORPH
تامكنت	NEWMORPH
تامور	NEWMORPH
تانكرت	NEWMORPH
تاهرت	NEWMORPH
تاياباذ	NEWMORPH
تبالة	بالَى,تَبالَه
تبان	تَبّان,أَبان
تبت	تِبِت,تَبّ-ِ,بَتّ,بات-ِ,تاب,أَبات
تبر	بَرّ-ِ,أَبَرّ,تَبَر-ِ,بَرَى-ِ,أَبار,بار,تِبْر
تبراك	أَبَرّ,تَبَر-ِ
تبريز	تَبْرِيز
تبسة	باس,بَسّ
تبشع	بَشِع-َ,بَشَّع
تبعة	تَبِعَة,تَبِع-َ,باع-ِ,تَبَع,أَباع
تبغر	بَغَر
تبل	بَلّ-ِ,بَلّ,بَلا,أَبال,تَبَل-ِ,تَبَّل,بال,بَلِي-َ,أَبَلّ,أَبْلَى,وَبَل-ِ
تبن	بَنَى-ِ,أَبان,تِبْن,تاب,تَبَنِّي,بان-ِ
تبنان	أَبان
تبنى	تِبْنِيّ,تَبّ-ِ,بَنَى-ِ,تِبْن,تَبَنَّى,أَبان,تَبَنِّي
تبنين	بَنَى-ِ,تَبَنَّى,أَبان
تبوك	تَبّ-ِ
تبيل	أَبال
تتا	NEWMORPH
تتش	NEWMORPH
تثلث	ثَلَّث
تثليث	تَثْلِيث
تثنيث	NEWMORPH
تجنية	تَجَنِّي,أَجَنّ,جَنَى-ِ,جَنّ
تجيب	أَجاب
تخاران	NEWMORPH
تخاوة	خاوَى
تختم	خَتَم-ِ
تخسانجكث	NEWMORPH
تخسيج	NEWMORPH
تخييم	NEWMORPH
تدليس	تَدْلِيس
تدمر	دَمَر,دَمَّر,تَدْمُر,تَدَمَّر
تدملة	دَمِل-َ,دَمَل
تدمير	تَدْمِير
تدورة	دَوَّر,دار
تدوم	دام,دَوَّم
تديانة	وَدَى-ِ
تذرب	ذَرِب-َ
تذكر	تَذَكُّر,ذَكَر,أَذْكَر,ذَكَّر,تَذَكَّر
ترابة	رابَى,تُراب,تُرابَة
تراخة	NEWMORPH
ترباع	NEWMORPH
تربان	تُراب,رَبّ
تربة	تَرَّب,تُرْبَة,راب-ِ,تِرْب,راب,أَراب,أَرْبَى,تَرِب,رَبَّى,رَبا
تربل	NEWMORPH
تربولة	NEWMORPH
ترج	تَرَجِّي,رَجا,رَجّ,راج,رَجِي-َ
ترجلة	تَرَجَّل,رَجَّل,رَجِل-َ
ترجيلة	NEWMORPH
ترحم	رَحَّم,تَرَحَّم,رَحِم-َ
ترسة	رَسا,رَسَّى,تَرَّس,تِرْس,تُرْس,أَرْسَى
ترسخ	تَرَسَّخ,رَسَخ,أَرْسَخ,رَسَّخ
ترشيش	NEWMORPH
ترعب	رَعَب-َ,رَعَّب,أَرْعَب
ترعة	أَرْعَى,تُرْعَة,راع,أَراع,رَعا,راع-ِ,رَعَى-َ
ترف	تَرِف,رَفّ-ِ,تَرِف-َ,رَفا,وَرَف-ِ,تَرَف,رَفّ
ترفلان	رَفَل
تركان	رَكّ,رَكّ-ِ
تركستان	تُرْكِسْتان
ترم	رَمّ-ِ,رام-ِ,وَرِم-ِ,رَمَى-ِ,رَمّ,رام
ترمد	رَمِد-َ,تَرَمَّد,رَمَّد
ترمذ	NEWMORPH
ترمس	تُرْمُس,رَمَس
ترمسان	رَمَس
ترمق	تَرَمَّق,رَمَّق,رَمَق
ترن	رَنّ-ِ,رَنا,ران-ِ,رَنَّى,أَرْنَى
ترناوذ	NEWMORPH
ترنك	رَنّ-ِ,رَنا,ران-ِ,رَنَّى,أَرْنَى
ترنوط	NEWMORPH
تروجة	راج,رَوَّج
تروغبذ	NEWMORPH
تروق	تَرَوَّق,رَوَّق,راق
تريادة	NEWMORPH
ترياع	NEWMORPH
ترياق	تِرْياق
تريك	وَرَى-ِ
تريم	رام-ِ,رَيَّم
تزاخى	NEWMORPH
تزمنت	NEWMORPH
تسارس	NEWMORPH
تستر	تَسَتُّر,سَتَر,سَتَّر,تَسَتَّر
تشكيدزه	NEWMORPH
تشمس	أَشْمَس,تَشَمَّس,شَمَّس,شَمِس-َ,شَمَس
تصلب	صَلَب-ِ,صَلُب,تَصَلَّب,تَصَلُّب,صَلَّب
تصيل	NEWMORPH
تضارع	ضارَع
تضاع	أَضاع
تضرع	ضَرَع,تَضَرَّع,تَضَرُّع
تضروع	NEWMORPH
تضلال	NEWMORPH
تطيلة	أَطال
تطيه	NEWMORPH
تعار	عار-َ,أَعار
تعاهن	NEWMORPH
تعز	عَزَى-ِ,عَزَّى,عَزا,تَعِزّ,أَعَزّ,عَزّ-ِ,عاز,عَزِي-َ
تعشار	NEWMORPH
تعشر	عَشَّر
تعكر	عَكِر-َ,تَعَكَّر,عَكَّر,تَعَكُّر
تعمر	عَمَر,أَعْمَر,عَمُر,عَمَّر,عَمِر-َ
تعنق	عَنَّق
تعهن	وَعَى-ِ
تغلم	غَلِم-َ
تغلمان	غَلِم-َ
تغن	غَنِي-َ,أَغْنَى,غَنّ-َ,أَغَنّ,غَنَّى
تغوث	غَوَّث
تفتازان	NEWMORPH
تفرنو	NEWMORPH
تفسرا	فَسَّر
تفليس	تَفْلِيس
تفهنا	فاه,تَفِه-َ,تَفَه
تقتد	ٱِقْتاد,ٱِقْتَدَى,ٱِقْتَدّ
تقوع	NEWMORPH
تقيد	قَيَّد,تَقَيُّد,تَقَيَّد,أَقاد
تقيوس	NEWMORPH
تكاب	NEWMORPH
تكاف	كافَى
تكتم	كَتَّم,تَكَتُّم,كَتَم,تَكَتَّم
تكث	كَثّ-ِ
تكرور	NEWMORPH
تكريت	تَكَرَّى,تِكْرِيت
تلبين	لَبّ-َُ,لَبّ,لَبَّى
تلعة	تَلْعَة
تلفياثا	NEWMORPH
تلفيتا	NEWMORPH
تلقم	لَقِم-َ,لَقَم,أَلْقَم,لَقَّم
تلمسان	تِلِمْسان,لَمَس
تلي	وَلِي-ِ,تَلّ
تليان	وَلِي-ِ
تليث	NEWMORPH
تليعفر	NEWMORPH
تليل	NEWMORPH
تمار	مارَى,تَمارّ,أَمار
تمتو	NEWMORPH
تمر	مار,مار-ِ,تَمْر,أَمَرّ,مَرّ,أَمار
تمرة	مار,مار-ِ,تَمْر,أَمَرّ,مَرّ,أَمار
تمرتاش	NEWMORPH
تمسا	وَمَس-ِ,مَسّ-َ
تمشكث	NEWMORPH
تمعق	NEWMORPH
تمني	تَمَنَّى,تَمَنِّي,مَنَى-ِ,مَنّ,مَنا,أَمَنّ,تُمَّن,مَنَّى
تمي	NEWMORPH
تميتمندان	NEWMORPH
تمير	مار-ِ,أَمار
تناتضة	NEWMORPH
تناصف	ناصَف
تناضب	NEWMORPH
تنب	ناب,نَبا,أَناب
تنبغ	ٱِنْبَغَى,نَبَغ-َُِ
تنبوك	نَبا
تنتلة	NEWMORPH
تنحيب	NEWMORPH
تندة	نَدَه-َ,نَدِي-َ,نَدَّى,نَدا,أَنْدَى,نَدّ-ِ,ناد
تنس	ناس,نَسِي-َ,تِنِس,أَنْسَى
تنصب	أَنْصَب,نَصَّب,ٱِنْصَبّ,نَصَب,نَصِب-َ
تنعة	نَعَى-َ,نَعَى-ِ
تنغة	نَغَى-ِ,نَغا
تنمص	NEWMORPH
تنهاة	نَهَى-ِ
تنهج	أَنْهَج,نَهَج-ِ,نَهَّج,نَهَج-َ,نَهِج-َ
تنوف	ناف
تنوق	تَنَوَّق
تنونية	نَوَّن
تنوهة	نَوَّه
تنيس	تِنِس
تنيضبة	NEWMORPH
تنين	وَنَى-ِ,تَنِّين,تِنِّين
تنينير	NEWMORPH
تهام	NEWMORPH
تهامة	تِهامَة
تهلل	هَلّ-ِ,تَهَلُّل,تَهَلَّل,أَهَلّ,هَلَّل
تهوذة	NEWMORPH
توارن	NEWMORPH
تؤام	NEWMORPH
توباذ	NEWMORPH
توبن	تَوَّب
توث	NEWMORPH
توثة	NEWMORPH
توج	تَوَّج
تود	وَدّ-َ,أَوْدَى,تُود
توذ	NEWMORPH
توذيج	NEWMORPH
توران	NEWMORPH
تورك	أَوْرَى,وَرَّى
توز	وَزّ
توزر	وَزِر-َ,أَوْزَر,تَوَزَّر
توسكاس	NEWMORPH
توضح	تَوَضَّح,وَضَّح,أَوْضَح
توضحان	وَضَّح,أَوْضَح
توقات	NEWMORPH
تولب	NEWMORPH
تولع	وَلَّع,تَوَلُّع,تَوَلَّع,وَلِع-َ,أَوْلَع
تولية	تَوْلِيَة,وَلَّى,أَوْلَى,تَوَلِّي
توم	تُوم
توما	تُوما
توماء	NEWMORPH
توماثا	NEWMORPH
تومن	NEWMORPH
تون	وَنَّى,وَنِي-َ,وَنّ-ِ
تونة	وَنَّى,تُونَة,وَنِي-َ,وَنّ-ِ
تونجة	تُونج
تونكث	NEWMORPH
توي	تَوّ
تويك	NEWMORPH
تياس	NEWMORPH
تياسان	NEWMORPH
تياسة	NEWMORPH
تيان	NEWMORPH
تيت	NEWMORPH
تيتد	NEWMORPH
تيدد	NEWMORPH
تيرا	NEWMORPH
تيراب	تَيْراب
تيرانشاه	NEWMORPH
تيرب	NEWMORPH
تيرة	NEWMORPH
تيركان	NEWMORPH
تيرم	NEWMORPH
تيرمردان	NEWMORPH
تيز	NEWMORPH
تيزان	NEWMORPH
تيزر	NEWMORPH
تيزين	NEWMORPH
تيش	NEWMORPH
تيفارين	NEWMORPH
تيفاش	NEWMORPH
تيل	تَيَّل
تيم	تِيم,تَيَّم
تيماء	تَيْماء
تيمار	NEWMORPH
تيمارستان	NEWMORPH
تيمر	NEWMORPH
تيمك	تَيَّم
تيمن	يَمَن,يَمِن-َ,يَمُن,يَمَّن,تَيَمَّن,تَيَمُّن,تَيَّم
تينات	NEWMORPH
تينان	NEWMORPH
تينزرت	NEWMORPH
تيهرت	NEWMORPH
ثاءة	ثاء
ثاب	ثاب
ثابري	NEWMORPH
ثات	NEWMORPH
ثاج	NEWMORPH
ثاجة	NEWMORPH
ثادق	NEWMORPH
ثافت	NEWMORPH
ثافل	NEWMORPH
ثبار	NEWMORPH
ثبر	ثَبَر
ثبرة	ثَبَر
ثبير	NEWMORPH
ثجة	NEWMORPH
ثجر	NEWMORPH
ثجل	NEWMORPH
ثخب	NEWMORPH
ثدواء	NEWMORPH
ثرا	ثَرّ
ثراثر	NEWMORPH
ثرام	NEWMORPH
ثربان	NEWMORPH
ثرم	ثَرِم-َ,ثَرَم-ِ
ثرمة	ثَرَم-ِ,ثَرِم-َ
ثرمد	NEWMORPH
ثرمداء	NEWMORPH
ثروان	NEWMORPH
ثرور	NEWMORPH
ثروق	NEWMORPH
ثريد	ثَرِيد
ثرير	NEWMORPH
ثعال	ثُعال
ثعالبات	NEWMORPH
ثعالة	ثُعال,ثُعالَة
ثعل	NEWMORPH
ثعيلبات	NEWMORPH
ثغرة	ثُغْرَة,ثَغْر
ثقبان	ثُقْب
ثقبة	ثَقْب,ثُقْبَة,ثُقْب,ثَقَّب,ثَقَب
ثقف	ثَقَّف,ثَقِف-َ,ثَقُف
ثقل	ثِقَل,ثَقُل,ثَقَّل
ثقيب	NEWMORPH
ثكامة	NEWMORPH
ثكد	NEWMORPH
ثكن	ثُكْنَة
ثلا	ثَلّ
ثلاث	ثَلاث
ثلاثان	NEWMORPH
ثما	NEWMORPH
ثماد	NEWMORPH
ثماني	ثَمِين,ثَمانِي
ثمانية	ثَمانِي
ثمانين	ثَمانُون
ثمر	ثَمَر
ثمغ	NEWMORPH
ثمهد	NEWMORPH
ثهلان	NEWMORPH
ثهلل	NEWMORPH
ثوابة	ثَوّاب,ثَواب
ثور	ثَوْر,ثَوَّر
ثورا	ثَوْر,ثَوَّر
ثيتل	ثَيْتَل
جابان	NEWMORPH
جابرس	NEWMORPH
جابروان	NEWMORPH
جابق	NEWMORPH
جابلق	NEWMORPH
جاجرم	NEWMORPH
جاجن	NEWMORPH
جادوا	جاد
جادية	جادّ
جاذر	NEWMORPH
جارف	جارِف
جاز	جاز
جازان	جازان
جازر	NEWMORPH
جاس	جاس
جاسك	جاس
جاسم	جاسِم
جاكرديزه	NEWMORPH
جاكه	NEWMORPH
جالصة	NEWMORPH
جالطة	NEWMORPH
جالقان	NEWMORPH
جاورسان	NEWMORPH
جاورسة	NEWMORPH
جبا	جُبّ,جَبّ
جباة	جابِي,جَبَى-ِ,جُبّ,جَبَّى,جَبّ,جَبْهَة
جباخان	NEWMORPH
جبار	جَبّار
جبان	جُبّ,جَبّان,جَبان
جبانا	جَبَى-ِ,جُبّ,جَبَّى,جَبّان,جَبّ,جَبان
جبانة	جَبّان,جَبانَة,جَبّانَة,جَبان
جبة	جُبّ,جُبَّة,جَبَه-َ,جَبّ
جبتل	NEWMORPH
جبثا	NEWMORPH
جبجب	NEWMORPH
جبرين	NEWMORPH
جبل	جَبَل
جبلان	جَبَل
جبلة	جِبْلَة,جَبَل,جِبِلَّة,جَبْلَة
جبن	جُبُن,جَبُن,جاب,جَبَّن,جُبْن
جبوب	NEWMORPH
جبى	جَبَى-ِ,جُبّ,جَبَّى
جبيل	جُبَيْل
جتاوب	NEWMORPH
جثا	جَثا,جَثّ
ججار	NEWMORPH
جحاف	NEWMORPH
جحشية	جَحْش
جحور	جُحْر
جخادة	NEWMORPH
جخزنى	NEWMORPH
جداء	جَدْي,جَداء
جداد	NEWMORPH
جدال	جَدّال,جِدال
جداوة	NEWMORPH
جدة	جِدَّة,جَدّ,جِدّ
جدد	جَدَّد,جَدِيد
جدر	جَدَّر,جَدُر,جَدِر-َ
جدرين	NEWMORPH
جدن	جاد
جدواء	NEWMORPH
جدود	جُدُود,جَدّ
جدورة	NEWMORPH
جديا	جَدْي,جِدِّيّ
جدية	جَدْي,جِدِّيَّة,جِدِّيّ,جَدّ
جديد	جَدِيد
جذاء	جَذْوَة
جذر	جَذَر,جَذَّر,جِذْر
جذم	جَذَم-ُِ,جِذْم,جَذِم-َ
جذمان	جِذْم
جذيذ	NEWMORPH
جذيمة	NEWMORPH
جراب	جِراب,جُراب
جراباذ	NEWMORPH
جراح	جَرّاح,جُرْح
جراد	جَراد
جرار	جَرَّة,جَرّار
جراز	NEWMORPH
جراف	NEWMORPH
جرام	جرام
جراميز	جَرامِز
جراوة	NEWMORPH
جرب	أَجْرَب,جِراب,جَرَّب,جَرِب-َ,جَرَب,جَرِب
جرباذقان	NEWMORPH
جربة	أَجْرَب,جِراب,جَرَّب,جَرَب,جَرِب
جربث	NEWMORPH
جربست	NEWMORPH
جربى	أَجْرَب,جِراب,جَرَب,جَرِب
جرت	جار,جَرَى-ِ,جَرّ
جرثم	NEWMORPH
جرج	NEWMORPH
جرجا	NEWMORPH
جرجان	NEWMORPH
جرجرايا	NEWMORPH
جرجسار	NEWMORPH
جرجنبان	NEWMORPH
جرجير	جِرْجِير
جرجين	NEWMORPH
جرحة	جُرْح,جَرَح-َ,جَرَّح
جرخان	NEWMORPH
جرخبند	NEWMORPH
جرد	جَرِد,جَرَّد,جَرْد,جَرَد
جردان	NEWMORPH
جردوس	NEWMORPH
جرذقيل	NEWMORPH
جرزان	NEWMORPH
جرزة	جَرَز,جُرْزَة
جرزوان	NEWMORPH
جرسيف	NEWMORPH
جرش	جَرْش,جَرَش
جرفاء	NEWMORPH
جرقوه	NEWMORPH
جركان	NEWMORPH
جرم	جِرْم,جَرْم,جُرْم,جَرَّم,جَرَم-ِ
جرماز	NEWMORPH
جرمانا	جِرْم,جَرْم,جَرَّم,جَرَم-ِ
جرمانس	NEWMORPH
جرمة	جِرْم,جَرْم,جُرْم,جَرَّم,جَرَم-ِ
جرمق	NEWMORPH
جرميذان	NEWMORPH
جرميهن	جِرْم,جَرْم
جرنبة	NEWMORPH
جرنى	جُرْن,جَرّ
جره	جُرَّة,جَرَّة,جَرّ
جرهد	NEWMORPH
جرواءان	NEWMORPH
جرواتكن	NEWMORPH
جرود	جَرِد
جرور	NEWMORPH
جروز	NEWMORPH
جروس	NEWMORPH
جرى	جَرْي,جَرَى-ِ,جَرّ
جريب	جَرِيب
جرير	جَرِير
جريرا	NEWMORPH
جرين	جَرَى-ِ
جز	جَزّ
جزء	جُزْء
جزاز	جَزّاز
جزب	NEWMORPH
جزباران	NEWMORPH
جزة	جِزَّة,جَزّ
جزجز	NEWMORPH
جزرة	جَزْر,جَزِيرَة,جَزَر,جَزَر-ِ,جَزْرَة
جزل	جَزْل,جَزُل
جزنق	NEWMORPH
جزه	جِزَّة,جَزّ
جسداء	NEWMORPH
جسرين	جِسْر
جش	جَشّ
جشر	NEWMORPH
جشم	جَشِم-َ,جَشَّم
جطا	NEWMORPH
جطين	NEWMORPH
جعبر	NEWMORPH
جعران	جِعْران
جعفي	NEWMORPH
جغانيان	NEWMORPH
جفجف	NEWMORPH
جفلوذ	NEWMORPH
جفن	جَفْن
جفير	NEWMORPH
جكان	NEWMORPH
جكران	NEWMORPH
جكل	NEWMORPH
جلاب	جُلاب,جُلّاب,جَلّاب
جلاباذ	NEWMORPH
جلاجيل	NEWMORPH
جلال	جَلال
جلالاباذ	NEWMORPH
جلاهيد	NEWMORPH
جلاوند	NEWMORPH
جلب	جَلْب,جَلَّب,جَلَب-ُِ,جَلَب
جلباط	NEWMORPH
جلجل	جَلْجَل,جُلْجُل
جلح	أَجْلَح,جَلِح-َ
جلخباقان	NEWMORPH
جلختجان	NEWMORPH
جلذان	NEWMORPH
جلس	جَلَس-ِ
جلصورى	NEWMORPH
جلعد	NEWMORPH
جلفار	NEWMORPH
جلفر	NEWMORPH
جلق	جِلِّق
جلك	جَلّ,جُلّ
جللتا	جَلَل,جَلَّل
جلمائرد	NEWMORPH
جلواباذ	NEWMORPH
جلوة	جَلا,جَلَى-ِ,جِلْوَة,جَلَّى
جلود	جَلُود
جلولاء	NEWMORPH
جلولتين	NEWMORPH
جليانة	جَلَيان
جلية	جَلِيّ,جَلِيَّة,جُلّ
جليجل	NEWMORPH
جليقية	NEWMORPH
جم	جَمّ,جَمّ-ُِ
جماجم	جُمْجُمَة
جماجمو	NEWMORPH
جمار	جُمّار
جماز	NEWMORPH
جماعيل	NEWMORPH
جمال	جَمال,جَمّال,جَمَل
جمان	جُمان,جَمّ
جمانة	جُمان,جُمانَة
جماهير	جُمْهُور
جمجروذ	NEWMORPH
جمدان	NEWMORPH
جمران	NEWMORPH
جمريس	NEWMORPH
جمز	NEWMORPH
جمع	جَمَع-َ,جَمَّع,جَمْع
جمل	جَمَّل,جُمْلَة,جَمُل,جَمَل
جميل	جَمِيل
جناب	جَناب
جنابة	جَناب,جَنابَة
جنابذ	NEWMORPH
جنارة	NEWMORPH
جناشك	NEWMORPH
جنان	جَنَّة
جنب	جَنَب,جَنْب,جَنَّب,جَنْبَ
جنباء	NEWMORPH
جنبذ	NEWMORPH
جنبل	NEWMORPH
جنبلاء	NEWMORPH
جنثاء	NEWMORPH
جنجان	NEWMORPH
جنجرة	NEWMORPH
جنجيال	NEWMORPH
جنجيلة	NEWMORPH
جند	جُنْد,جَنَّد
جندة	جُنْد,جَنَّد
جندع	NEWMORPH
جندف	NEWMORPH
جندفرح	NEWMORPH
جندفرقان	NEWMORPH
جندويه	NEWMORPH
جنديسابور	NEWMORPH
جنديشاهبور	NEWMORPH
جندين	NEWMORPH
جنديوخسره	NEWMORPH
جنزة	جَنَّز
جنزروذ	NEWMORPH
جنزوذ	NEWMORPH
جنش	NEWMORPH
جنقان	NEWMORPH
جنوجرد	NEWMORPH
جهار	جِهار
جهجوه	NEWMORPH
جهران	NEWMORPH
جهرم	NEWMORPH
جهوذان	NEWMORPH
جهوذانك	NEWMORPH
جهور	جَهْوَر
جهينة	جُهَيْنَة,جَهِي-َ
جو	جَوّ,جُو
جواثاء	NEWMORPH
جوادة	جَواد
جوارة	جِوار
جوالى	جالِيَة,جَوّال,جُوال
جواندان	NEWMORPH
جوانكان	NEWMORPH
جوب	جَوْب
جوبار	NEWMORPH
جوبان	NEWMORPH
جوبر	NEWMORPH
جوبرة	NEWMORPH
جوبرقان	NEWMORPH
جوبق	NEWMORPH
جوبه	جَوْب,جَوْبَة
جوبيناباذ	NEWMORPH
جوثاء	NEWMORPH
جوجر	NEWMORPH
جوخا	جُوخ
جوخاء	NEWMORPH
جوخان	NEWMORPH
جودة	جَوْدَة
جوذرز	NEWMORPH
جوذقان	NEWMORPH
جوذمه	NEWMORPH
جور	جُورَة,جَوْر
جوراب	NEWMORPH
جوران	NEWMORPH
جوربذ	NEWMORPH
جورتان	جُورَة
جورجير	NEWMORPH
جوز	جَوْز,جَوَّز
جوزان	جَوْز
جوزجانان	NEWMORPH
جوزدان	NEWMORPH
جوزران	NEWMORPH
جوزفلق	NEWMORPH
جوزق	NEWMORPH
جوزقان	NEWMORPH
جوزه	جَوْز,جَوَّز
جوسقان	جَوْسَق
جوسية	NEWMORPH
جوش	NEWMORPH
جوشن	NEWMORPH
جوغان	NEWMORPH
جوف	جَوْف,جَوَّف,أَجْوَف
جوفر	NEWMORPH
جوكان	NEWMORPH
جولى	جُولِي
جومة	NEWMORPH
جومل	NEWMORPH
جونب	NEWMORPH
جونة	جُون
جونية	جُونِيَة
جوهة	NEWMORPH
جويبار	NEWMORPH
جويخان	NEWMORPH
جويك	جَوِّيّ
جويم	NEWMORPH
جوين	جَوِي-َ
جي	جِي
جياد	جَيِّد
جيار	جَيّار
جياسر	NEWMORPH
جيان	NEWMORPH
جيجل	NEWMORPH
جيجون	NEWMORPH
جيحان	NEWMORPH
جيخن	NEWMORPH
جيدة	جَيِّد
جيذا	NEWMORPH
جير	جَيَّر,جِير
جيراخشت	NEWMORPH
جيرامزدان	NEWMORPH
جيران	جار
جيرة	جِيرَة,جَيَّر,جِير
جيرفت	NEWMORPH
جيرم	NEWMORPH
جيرنج	NEWMORPH
جيرنخجير	NEWMORPH
جيروت	NEWMORPH
جيرون	NEWMORPH
جيزاباذ	NEWMORPH
جيشان	جَيْش,جَيَشان
جيشبر	NEWMORPH
جيكان	NEWMORPH
جيلاباذ	NEWMORPH
جيلان	جِيل
جيلة	جِيل
جينانجكث	NEWMORPH
جينين	جِين
جيهان	جِيهان
حابس	NEWMORPH
حاج	حاجّ
حاجة	حاجَة,حاجّ
حارة	حارَة,حارّ,حار
حارم	NEWMORPH
حازة	حاز-ِ,حاز
حاس	NEWMORPH
حاسم	حاسِم
حاصورا	NEWMORPH
حاطب	حاطِب
حافد	NEWMORPH
حافر	حافِر
حامر	NEWMORPH
حاني	حان
حائل	حائِل
حب	حَبّ,حَبّ-ِ,حُبّ
حباباء	NEWMORPH
حباران	NEWMORPH
حباشة	NEWMORPH
حبال	حَبْل
حبان	NEWMORPH
حبانية	NEWMORPH
حبتون	NEWMORPH
حبجرى	NEWMORPH
حبر	حَبْر,حَبَّر,حَبِر-َ,حِبْر,حَبَر
حبران	NEWMORPH
حبرة	حَبْر,حَبَرَة,حَبَّر,حِبْر,حَبَر
حبرون	NEWMORPH
حبرير	NEWMORPH
حبس	حَبْس,حَبَس-ِ,حِبْس
حبسان	حِبْس
حبشى	حَبَشِيّ,حَبَش
حبشي	حَبَشِيّ,حَبَش
حبل	حَبَل,حَبِل,حَبَّل,حَبْل
حبلة	حَبَل,حَبَّل,حَبْل
حبنج	NEWMORPH
حبوتن	حَبا
حبوكر	NEWMORPH
حبونن	NEWMORPH
حبونى	حَبّ-ِ,حَبا
حبى	حَبّ,حُبِّيّ,حُبّ
حبي	حَبّ,حُبِّيّ,حُبّ
حبيب	حَبِيب
حبيبة	حُبَيْبَة,حَبِيب
حبير	NEWMORPH
حبيس	حَبِيس
حبيش	NEWMORPH
حبيض	NEWMORPH
حبين	NEWMORPH
حتاوة	NEWMORPH
حتمة	حَتَّم,حَتْم,حَتَم-ِ
حثاث	NEWMORPH
حثمة	NEWMORPH
حثن	NEWMORPH
حجاج	حاجّ
حجبة	حاجِب,حَجَّب,حَجَب,حِجاب,حَجْب
حجة	حِجَّة,حُجَّة,حَجّ
حجر	حُجْرَة,حَجَر,حَجَّر,حِجْر,حَجْر
حجرا	حُجْرَة,حَجَر,حَجَّر,حَجْر,حِجْر
حجرة	حُجْرَة,حَجَر,حَجَّر,حَجْر,حِجْر
حجور	NEWMORPH
حجيان	حَجِيّ
حجيرا	NEWMORPH
حداء	حَدَأَة,حَدّاء,حُداء
حداب	حَدَب
حداره	NEWMORPH
حدان	NEWMORPH
حدة	حِدَة,حِدَّة,حَدّ
حدثة	حَدَث
حدد	حَدَّد
حدر	حَدَر-ِ,حَدَّر,حَدُر,حَدَر
حدس	حَدْس,حَدَس-ُِ
حدمة	NEWMORPH
حدواء	NEWMORPH
حدوداء	NEWMORPH
حدورة	حَدُور
حديجاء	NEWMORPH
حديلة	NEWMORPH
حذارق	NEWMORPH
حذية	NEWMORPH
حذيم	NEWMORPH
حر	حُرّ,حَرّ
حرا	حُرّ,حَرّ
حراء	حِراء
حرار	حَرّان,حَرّار
حراز	NEWMORPH
حراض	NEWMORPH
حراضان	NEWMORPH
حراضة	NEWMORPH
حرام	حَرام
حران	حُرّ,حَرّان
حرب	حَرْب
حربة	حَرْبَة,حَرْب
حربث	NEWMORPH
حربنفسا	NEWMORPH
حربنوش	NEWMORPH
حربى	حَرْبِيّ,حَرْب
حرة	حُرّ,حَرَّة,حَرّ
حرث	حَرَث-ُِ,حَرْث
حرج	حَرَّج,حَرَج,حَرِج-َ,حَرِج
حرجة	حَرَّج,حَرَج,حَرِج
حرد	حَرِد,حَرِد-َ,حَرَد
حردان	حَرْدان,حَرِد
حردة	حَرِد,حَرَد
حردفنة	NEWMORPH
حردفنين	NEWMORPH
حرزم	NEWMORPH
حرس	حَرَس
حرستا	حَرَس
حرشان	حَرِش
حرص	حَرِص-َ,حَرَص-ِ,حِرْص
حرض	حَرَض-ِ,حَرَّض
حرف	حَرْف,حِرْفَة,حَرَف-ِ,حَرَّف
حرقم	NEWMORPH
حرك	حُرّ,حَرَّك,حَرّ
حرلان	NEWMORPH
حرم	حَرِم-َ,حُرْمَة,حَرُم,حَرَّم,حَرَم,حَرَم-ُِ
حرمة	حُرْمَة,حَرَّم,حَرَم,حَرَم-ُِ
حرنة	حار
حرنق	NEWMORPH
حروراء	NEWMORPH
حروس	NEWMORPH
حريات	حَرِيّ,حُرِّيَّة
حريداء	NEWMORPH
حريز	حَرِيز
حريم	حَرِيم
حرين	حُرّ,حَرَى
حريوين	NEWMORPH
حزاء	NEWMORPH
حزاز	حَزاز
حزة	حَزّ
حزر	حَزْر,حَزَر-ُِ
حزرة	حَزْر,حَزَر-ُِ
حزرم	NEWMORPH
حزمان	NEWMORPH
حزن	حَزَن,حَزْن,حَزَّن,حُزْن,حاز,حاز-ِ,حَزِن-َ
حزنة	حَزَن,حَزْن,حَزَّن,حُزْن,حاز-ِ,حاز
حزواء	NEWMORPH
حزورة	حَزُّورَة
حزوى	NEWMORPH
حزيز	NEWMORPH
حسا	حِسّ,حَسا,حَسّ,حَسّ-ِ
حسان	حَسَن
حسلات	NEWMORPH
حسلة	NEWMORPH
حسم	حَسَم-ِ,حَسْم
حسمى	حَسْم
حسنا	حَسَّن,حَسَن,حَسُن,حُسْن,حِسّ,حَسّ,حَسّ-ِ
حسناباذ	NEWMORPH
حسنة	حَسَنَة,حَسَّن,حَسَن,حُسْن
حسيكة	NEWMORPH
حسيلة	NEWMORPH
حشاش	حُشاش,حَشّاش
حشان	NEWMORPH
حشر	حَشَر-ُِ,حَشْر
حصان	حِصان
حصناباذ	NEWMORPH
حصير	حَصِير
حضار	NEWMORPH
حضارة	حَضارَة
حضارم	حَضْرَمِيّ
حضر	حَضَّر,حَضَر
حضرة	حَضَّر,حَضَر,حَضْرَة
حضرموت	حَضْرَمَوْت
حضن	حاض-ِ,حِضْن,حَضَن
حضوة	حَضّ
حضور	حُضُور
حضوضى	NEWMORPH
حضيان	NEWMORPH
حضير	NEWMORPH
حطين	حِطِّين
حظيان	حَظِيّ
حفاء	NEWMORPH
حفار	حَفّار
حفاش	NEWMORPH
حفاف	حِفاف
حفان	NEWMORPH
حفائل	NEWMORPH
حفر	حَفَر-ِ,حُفْرَة,حَفْر
حفصاباذ	NEWMORPH
حفن	حَفَن,حاف-ِ
حفنا	حَفَن,حَفّ,حاف-ِ
حفياء	NEWMORPH
حفيتن	حَفِي-َ
حفير	حَفِير
حقاء	حَقْو
حقال	NEWMORPH
حقل	حَقْل
حقلاء	NEWMORPH
حقيل	NEWMORPH
حقين	NEWMORPH
حكم	حَكَّم,حُكْم,حَكَم
حكمان	حُكْم,حَكَم
حلاحل	NEWMORPH
حلال	حَلال
حلامات	NEWMORPH
حلب	حَلَب,حَلَب-ُِ,حَلْب
حلبان	NEWMORPH
حلبة	حَلَب,حَلْبَة,حَلَب-ُِ,حَلْب
حلحل	حَلْحَل
حلحول	حَلْحُول
حلف	حَلَّف,حَلَف-ِ,حَلْف,حِلْف
حلفبلتا	NEWMORPH
حلوان	حُلْوان,حُلْو
حلوة	حَلَى,حَلَّى,حُلْوَة,حُلْو,حَلّ
حلي	حِلّ,حَلْي,حَلَى,حِلْيَة,حَلَّى,حَلِي-َ,حَلّ
حلية	حَلْي,حِلْيَة,حَلّ
حليت	حَلَى,حَلَّى,حَلِي-َ
حليمات	حَلِيم
حليمة	حَلِيم
حم	حَم,حَمّ
حماة	حُمَة,حَم,حِمَى,حَمّ,حَمَى-ِ,حَماة,حُمَّى,حامِي,حَمَّى
حماتا	حَماة
حماد	حَمّاد
حمار	حَمّار,حِمار
حماس	حَماس
حماساء	NEWMORPH
حماط	حَماط
حماطان	NEWMORPH
حماك	حُمَة,حَم,حِمَى,حَمّ,حَمَى-ِ,حُمَّى,حَمَّى
حمال	حَمّال
حمام	حَمام,حَمّام
حمامة	حَمام,حَمّام
حمة	حُمَة,حَم,حُمَّة,حَمَّة,حَمّ
حمدان	حَمْدان
حمر	حُمَر,حَمَّر,حِمار,أَحْمَر
حمران	NEWMORPH
حمراندز	NEWMORPH
حمزان	NEWMORPH
حمزة	حَمْزَة,حَمْز,حَمَز-ِ
حمص	حِمْص,حَمَّص,حُمُّص
حمض	حَمْض,حَمُض,حَمَّض
حمضة	حَمْض,حَمَّض
حمضى	حَمْض,حَمْضِيّ
حمل	حَمْل,حَمَل,حِمْل,حَمَل-ِ,حَمَّل
حملان	NEWMORPH
حمم	حُمَم,حَمَّم
حمنان	NEWMORPH
حمورية	NEWMORPH
حميان	حَمِيّ,حُمِّيّ
حمير	حِمار
حميض	NEWMORPH
حميط	NEWMORPH
حناك	حان-ِ
حنبا	NEWMORPH
حنبل	حَنْبَل
حنجر	حَنْجَر
حندرة	NEWMORPH
حندوثا	NEWMORPH
حنذ	NEWMORPH
حنش	حَنَش
حنص	NEWMORPH
حنظلة	حَنْظَل
حنيذ	NEWMORPH
حنيف	حَنِيف
حنين	حَنِين
حنيناء	NEWMORPH
حواء	حَوّاء
حوار	حارَة,حِوار
حوارة	حُوّارَة,حَوّارَة,حِوار
حوارين	حِوار
حواطب	NEWMORPH
حواق	NEWMORPH
حوان	حَوانِي
حوايا	حَوِيَّة
حواية	حَوايَة
حوتنانان	NEWMORPH
حور	حَوَّر,أَحْوَر,حَوِر-َ,حَوَر,حُورِيَّة
حوراء	أَحْوَر
حوران	حَوْران
حورة	حَوَّر,أَحْوَر,حَوَر,حُورِيَّة
حورى	أَحْوَر,حَوَر,حُورِيَّة
حوزان	NEWMORPH
حوزة	حَوْز,حَوْزَة
حوشب	NEWMORPH
حوشي	حَوَش,حَوْش,حُوشِيّ
حوصاء	حَوَص
حوصلاء	NEWMORPH
حوضاء	NEWMORPH
حوضى	حَوْض
حوط	حَوَّط
حوق	حَوَّق
حولان	NEWMORPH
حولايا	NEWMORPH
حومل	NEWMORPH
حومى	NEWMORPH
حوي	حَوَى-ِ
حويذان	NEWMORPH
حياء	حَياء
حيان	حَيّ
حياوة	NEWMORPH
حية	حَيّ,حَيّ-َ,حَيَّة
حيدة	حَيْدَة,حَيْد,حَيَّد
حيدث	NEWMORPH
حيرة	حَيْرَة,حَيَّر,حَيْر
حيزان	حَيِّز
حيس	NEWMORPH
حيض	حَيْض
حيطوب	NEWMORPH
حيفا	حَيْفا,حَيْف
حيفاء	NEWMORPH
حيلان	NEWMORPH
حيلة	حِيلَة,حَيْل
حيني	حَيّ-َ,حِين,حِينَ,حَيْن
خابران	NEWMORPH
خابوراء	NEWMORPH
خاجر	NEWMORPH
خاخ	NEWMORPH
خاخسر	NEWMORPH
خار	خار-ِ,خار
خاربان	خارِب
خارجة	خارِجَ,خارِجَة,خارِج
خارزنج	NEWMORPH
خارك	خار-ِ,خار
خازر	NEWMORPH
خاست	خاس-ِ
خاشت	NEWMORPH
خاشتي	NEWMORPH
خاشك	NEWMORPH
خاص	خاصّ
خاكة	NEWMORPH
خاكساران	NEWMORPH
خالبرزن	NEWMORPH
خالة	خالَة,خالّ,خال-َ,خال
خالد	خالِد
خالداباذ	NEWMORPH
خامر	خامَر
خان	خان
خانجاه	NEWMORPH
خانسار	NEWMORPH
خانق	خانِق,خانَق
خانقين	خانِق
خانيجار	NEWMORPH
خاور	NEWMORPH
خاوران	NEWMORPH
خاوس	NEWMORPH
خبء	NEWMORPH
خباش	NEWMORPH
خباق	NEWMORPH
خبان	خَبّ
خبائر	NEWMORPH
خبة	خَبّ,خَبّ-َ
خبت	خَبا,خاب-ِ,خَبّ,خَبّ-َ
خبتع	NEWMORPH
خبج	NEWMORPH
خبجبة	NEWMORPH
خبر	خَبُر,خُبَر,خَبَر,خَبَّر
خبرة	خِبْرَة,خَبُر,خُبَر,خَبَر,خَبَّر
خبرين	خَبَر
خبزة	خَبَز-ِ,خُبْز
خبق	NEWMORPH
خبنك	خاب-ِ
خبوشان	NEWMORPH
خبي	خَبّ
خبيب	خَبِيب
خبيت	NEWMORPH
خت	NEWMORPH
ختا	NEWMORPH
خترب	NEWMORPH
ختلان	NEWMORPH
ختن	خَتْن,خَتَن-ِ
ختى	NEWMORPH
خجادة	NEWMORPH
خجستان	NEWMORPH
خجندة	NEWMORPH
خدا	خَدّ
خداباذ	NEWMORPH
خداد	NEWMORPH
خدار	NEWMORPH
خدد	NEWMORPH
خدعة	خُدْعَة,خَدْع,خَدَع-َ
خدفران	NEWMORPH
خدوراء	NEWMORPH
خديسر	NEWMORPH
خديمنكن	NEWMORPH
خذابان	NEWMORPH
خذارق	NEWMORPH
خذام	NEWMORPH
خذاند	NEWMORPH
خذقدونة	NEWMORPH
خذيفة	NEWMORPH
خر	خَرّ,خَرّ-ُِ,خُر
خراب	خَراب
خراجرى	NEWMORPH
خرادين	NEWMORPH
خراس	NEWMORPH
خراسان	خُراسان
خراسكان	NEWMORPH
خراص	خَرّاص
خرانديز	NEWMORPH
خرب	خَرِب,خَرِب-َ,خَرَب-ِ,خَرَّب
خربا	خَرِب,خَرِب-َ,خَرَب-ِ,خَرَّب
خربتا	خَرِب,خَرِب-َ,خَرَب-ِ,خَرَّب
خرتبرت	NEWMORPH
خرتنك	خَرَت
خرتير	NEWMORPH
خرجان	NEWMORPH
خرجة	خَرْج,خَرَّج
خرجرد	NEWMORPH
خرجوش	NEWMORPH
خرخان	NEWMORPH
خرزة	خَرَز-ُِ,خَرَز
خرس	أَخْرَس,خَرَس,خَرِس-َ
خرستاباذ	NEWMORPH
خرشاف	NEWMORPH
خرشان	NEWMORPH
خرشكت	NEWMORPH
خرشنة	NEWMORPH
خرشنون	NEWMORPH
خرشيد	NEWMORPH
خرطط	NEWMORPH
خرعون	NEWMORPH
خرغانكث	NEWMORPH
خرق	أَخْرَق,خِرْقَة,خَرْق,خَرَق-ُِ
خرقان	NEWMORPH
خرقانة	NEWMORPH
خركن	خَرّ
خركوش	NEWMORPH
خرم	خَرْم,خَرَم-ِ,خُرْم,خَرَّم
خرماباذ	NEWMORPH
خرماروذ	NEWMORPH
خرمان	خَرْم,خُرْم
خرمة	خَرْم,خَرَم-ِ,خُرْم,خَرَّم
خرملاء	NEWMORPH
خرميثن	NEWMORPH
خرن	خار-ِ,خار
خرنباء	NEWMORPH
خرنق	خِرْنِق
خروب	خَرُّوب
خرور	خُرُور
خرورنج	NEWMORPH
خرون	NEWMORPH
خريبة	NEWMORPH
خرير	خَرِير
خريشيم	NEWMORPH
خريق	NEWMORPH
خريم	NEWMORPH
خزار	NEWMORPH
خزاز	NEWMORPH
خزاق	NEWMORPH
خزالى	NEWMORPH
خزام	خِزام
خزاند	NEWMORPH
خزب	NEWMORPH
خزبة	NEWMORPH
خزر	خَزَر
خزمان	NEWMORPH
خزوان	NEWMORPH
خزوزى	خُزُوز
خزيبة	NEWMORPH
خساف	NEWMORPH
خست	خَسّ-َ,خَسّ,خاس-ِ
خسراباذ	NEWMORPH
خسراهاباذ	NEWMORPH
خسراوية	NEWMORPH
خسروجرد	NEWMORPH
خسروسابور	NEWMORPH
خسروشاه	NEWMORPH
خسفين	NEWMORPH
خش	خَشّ
خشا	خَشّ
خشاب	NEWMORPH
خشاخش	NEWMORPH
خشاش	خِشاش
خشاغر	NEWMORPH
خشاورة	NEWMORPH
خشب	خَشَب,خَشَّب
خشبان	NEWMORPH
خشرتي	NEWMORPH
خشعان	NEWMORPH
خشك	خَشّ
خشكرد	NEWMORPH
خشكروذ	NEWMORPH
خشمنجكث	NEWMORPH
خشميثن	NEWMORPH
خشن	أَخْشَن,خَشَّن,خَشِن,خَشُن
خشوب	NEWMORPH
خشوفغن	NEWMORPH
خشوننجكث	NEWMORPH
خشيبة	NEWMORPH
خشين	خَشِي-َ,خَشَّى
خشينان	NEWMORPH
خشينديزه	NEWMORPH
خصا	خَصّ,خُصّ
خصر	خَصْر,خَصِر-َ
خصفى	NEWMORPH
خصلة	خَصْلَة,خُصْلَة
خصيل	NEWMORPH
خضاب	خِضاب
خضراء	أَخْضَر
خضرة	خَضَّر,خَضِر,خُضْرَة
خضرمة	خِضْرِم
خضلات	خَضِل
خضم	خِضَمّ,خَضَم-ِ
خضمان	خِضَمّ
خضوراء	NEWMORPH
خطرنية	NEWMORPH
خطم	خَطْم
خطمة	خَطْم
خطى	خَطَّى,خَطْوَة,خَطِّيّ,خَطّ
خفاف	خَفِيف,خَفاف,خُفّ
خفان	خُفّان,خُفّ
خفتيان	NEWMORPH
خفتيذكان	NEWMORPH
خفدان	NEWMORPH
خفية	خُفْيَة,خَفِيّ,خَفِيَّة,خُفّ
خفينن	NEWMORPH
خكنجه	NEWMORPH
خلاد	NEWMORPH
خلار	NEWMORPH
خلاط	خَلّاط
خلاطا	خَلّاط
خلال	خِلالَ,خِلال
خلائل	NEWMORPH
خلبتا	خَلَب,خَلَب-ِ
خلة	خَلَّة,خُلَّة,خَلّ
خلج	خَلِيج,خَلَج-ِ
خلخال	خَلْخال
خلص	خَلَص,خالِص,خَلَّص
خلم	NEWMORPH
خليب	NEWMORPH
خليت	خَلَّى
خليص	خَلِيص
خليفة	خَلِيفَة
خليقة	خَلِيق
خليقى	خَلِيق
خم	خُمّ,خَمّ
خماء	NEWMORPH
خمار	خُمار,خَمّار,خِمار
خماساء	NEWMORPH
خماصة	NEWMORPH
خمان	NEWMORPH
خمايجان	NEWMORPH
خمة	خَمَّة,خُمّ,خَمّ
خمخيسرة	NEWMORPH
خمرا	خَمْر,خَمَّر,خَمَر,خِمار
خمران	NEWMORPH
خمربرت	NEWMORPH
خمرك	خَمْر,خَمَّر,خَمَر,خِمار
خمطة	NEWMORPH
خمقاباذ	NEWMORPH
خمقرى	NEWMORPH
خمليخ	NEWMORPH
خميثن	NEWMORPH
خمير	خَمِير,خِمِّير
خميل	NEWMORPH
خناب	NEWMORPH
خناثا	خُنْثَى
خناجن	NEWMORPH
خناس	خَنّاس
خناصرة	خِنْصِر
خنامتى	NEWMORPH
خنبون	NEWMORPH
خنثل	NEWMORPH
خنجرة	خَنْجَر
خنداذ	NEWMORPH
خندروذ	NEWMORPH
خندمة	NEWMORPH
خنزب	خَنْزَب
خنزج	NEWMORPH
خنزر	NEWMORPH
خنزرة	NEWMORPH
خنزير	خِنْزِير
خنعس	NEWMORPH
خنفر	خَنْفَر
خنفس	خُنْفُس
خنليق	NEWMORPH
خنور	NEWMORPH
خنوقاء	NEWMORPH
خنية	NEWMORPH
خنيس	NEWMORPH
خو	NEWMORPH
خوابذان	NEWMORPH
خوار	خُوار,خَوّار
خوارج	خَوارِج
خوارزم	NEWMORPH
خواش	NEWMORPH
خواشت	NEWMORPH
خواف	خافِيَة,خَوّاف
خواقند	NEWMORPH
خواية	NEWMORPH
خوجان	NEWMORPH
خود	NEWMORPH
خور	خَوْر,خَوِر-َ,خَوَر
خورزن	NEWMORPH
خورم	NEWMORPH
خوز	NEWMORPH
خوزان	NEWMORPH
خوزستان	خُوزِسْتان
خوزيان	NEWMORPH
خوست	خُوست
خوسر	NEWMORPH
خوش	NEWMORPH
خوشب	NEWMORPH
خوصاء	NEWMORPH
خوط	NEWMORPH
خوع	NEWMORPH
خولان	NEWMORPH
خولنجان	NEWMORPH
خومين	NEWMORPH
خونا	خَوَّن
خونت	خَوَّن
خونج	NEWMORPH
خونجان	NEWMORPH
خونيان	NEWMORPH
خوي	خَوَى-ِ,خَواء,خَوِي-َ,خُوَي
خويث	NEWMORPH
خويلفة	NEWMORPH
خيابر	NEWMORPH
خياذان	NEWMORPH
خيارة	خَيْر,خِيار
خيازج	NEWMORPH
خيام	خَيْمَة,خَيّام
خيبر	خَيْبَر
خيت	NEWMORPH
خيدب	NEWMORPH
خيدشتر	NEWMORPH
خير	خَيِّر,خَيْر,خَيَّر
خيران	خَوْر,خَيِّر
خيرة	خَيِّر,خِيرَة,خَيْر,خَيَّر,خَيْرَة
خيرج	NEWMORPH
خيرين	خَيِّر
خيزاخزا	NEWMORPH
خيزار	NEWMORPH
خيس	خَيْس
خيسار	NEWMORPH
خيسق	NEWMORPH
خيش	خَيْش
خيشان	NEWMORPH
خيصل	NEWMORPH
خيف	NEWMORPH
خيفق	NEWMORPH
خيقمان	NEWMORPH
خيل	أَخْيَل,خَيَّل,خَيْل
خيلام	NEWMORPH
خيلع	NEWMORPH
خيم	خَيْمَة,خَيَّم,خِيم
خيماء	NEWMORPH
خيمر	NEWMORPH
خين	NEWMORPH
خينف	NEWMORPH
خيوان	NEWMORPH
خيوق	NEWMORPH
دءاث	NEWMORPH
داءة	داء
دابق	NEWMORPH
داث	NEWMORPH
داثر	NEWMORPH
داثن	NEWMORPH
داجون	داجِي
دادم	NEWMORPH
داذوما	NEWMORPH
دار	دار,دارّ,دارِي
دارا	دار,دارا,دارّ
داراء	NEWMORPH
دارابجرد	NEWMORPH
دارة	دار,دارَة,دارّ
دارتان	دارَة,دارّ
دارزنج	NEWMORPH
دارك	دارَك,دار,دارّ
داركان	NEWMORPH
داروما	NEWMORPH
داريا	دارِيّ,دارَى,دارِي
داسر	داسِر
داسن	NEWMORPH
داشيلوا	NEWMORPH
داعية	داعِي,داعِيَة
دامان	NEWMORPH
دامغان	دامِغ
داموس	NEWMORPH
دانا	دان-ِ
دانية	دانِي
دانيث	NEWMORPH
داور	داوَر
داوردان	NEWMORPH
داوودان	NEWMORPH
دايان	NEWMORPH
دبا	دَبّ-ِ,دُبّ
دباب	دَبّاب
دبالة	NEWMORPH
دباها	دَبّ-ِ,دُبّ
دباوند	NEWMORPH
دبثا	NEWMORPH
دبر	دَبَّر,دَبَر,دُبْر
دبزن	NEWMORPH
دبزند	NEWMORPH
دبقا	دِبْق,دَبِق-َ,دَبَّق,دَبِق
دبل	دِبْلَة
دبوب	NEWMORPH
دبورية	دَبُّور
دبوسية	دَبُّوس
دبيثا	NEWMORPH
دبير	NEWMORPH
دبيرا	NEWMORPH
دبيق	NEWMORPH
دبيل	NEWMORPH
دثر	دِثار,دَثَّر,دَثَر
دثين	NEWMORPH
دجاكن	دَجا,دُجَى,دَجّ-ِ
دجرجا	NEWMORPH
دجلة	دَجْل,دَجَل,دَجَّل,دِجْلَة
دجوة	دَجا,دَجّ-ِ
دجوج	NEWMORPH
دجيل	NEWMORPH
دحل	دَحَل
دحنا	NEWMORPH
دحوض	دُحُوض
دحي	NEWMORPH
دحيضة	NEWMORPH
دخفندون	NEWMORPH
دخكث	NEWMORPH
دخل	دَخْل,دَخَل
دخلة	دُخْلَة,دَخْل,دَخَل,دُخَّلَة,دِخْلَة
دخميس	NEWMORPH
دد	NEWMORPH
ددن	NEWMORPH
در	دَرّ,دُرّ,دَرّ-ُِ
درابجرد	NEWMORPH
درادر	NEWMORPH
دراسفيد	NEWMORPH
دراورد	NEWMORPH
درب	دَرِب-َ,دَرْب,دَرَّب
دربا	دَرِب-َ,دَرْب,دَرَّب
درباشيا	NEWMORPH
دربند	NEWMORPH
دربيشية	NEWMORPH
دربيقان	NEWMORPH
درتا	دَرَى-ِ,دُرّ,دَرّ-ُِ
درخشك	NEWMORPH
درخيد	NEWMORPH
دردشت	دَرْدَش
دردور	دُرْدُور,دَرْدُور
درزده	NEWMORPH
درزيجان	NEWMORPH
درزيو	NEWMORPH
درسينان	NEWMORPH
درعة	دِرْع,دَرَّع
درغان	NEWMORPH
درغم	NEWMORPH
درغوز	NEWMORPH
درغينة	NEWMORPH
درق	دَرَق
درقيط	NEWMORPH
درك	دَرّ,دُرّ,دَرِك,دَرَّك,دَرَك
دركجين	NEWMORPH
دركزين	NEWMORPH
دركوش	NEWMORPH
درن	دَرَن,دَرِن-َ,دار
درنا	دَرَن,دَرِن-َ,دَرّ,دُرّ,دار
درنة	دَرَن,دَرَنَة,دار
دره	دَرّ,دُرّ,دِرَّة
دروازق	NEWMORPH
دروت	NEWMORPH
دروذ	NEWMORPH
دروقة	NEWMORPH
درولية	NEWMORPH
دريجة	NEWMORPH
دريجه	NEWMORPH
دريرات	NEWMORPH
دزاه	NEWMORPH
دزباز	NEWMORPH
دزبز	NEWMORPH
دزق	NEWMORPH
دزمار	NEWMORPH
دسبندس	NEWMORPH
دستبى	NEWMORPH
دستجرد	NEWMORPH
دستميسان	NEWMORPH
دستوا	NEWMORPH
دسم	دَسَم,أَدْسَم,دَسِم
دسمان	دَسِم
دشتك	دَشْت,دَشّ
دشتيه	NEWMORPH
دشنتة	دَشَّن
دشنى	دَشّ
دعان	NEWMORPH
دعانيم	NEWMORPH
دعتب	NEWMORPH
دعمان	NEWMORPH
دعمة	دَعَم-َ,دِعْمَة,دَعَّم,دَعْم
دعنج	NEWMORPH
دغنان	NEWMORPH
دغوث	NEWMORPH
دفا	دَفّ,دَفّ-ِ,دُفّ
دفاق	دَفّاق
دفون	NEWMORPH
دقاتش	NEWMORPH
دقانية	NEWMORPH
دقدوس	NEWMORPH
دقران	NEWMORPH
دقرى	NEWMORPH
دقلة	دَقْل,دَقَل
دقهلة	NEWMORPH
دقوقاء	NEWMORPH
دكالة	NEWMORPH
دكمة	NEWMORPH
دلاص	NEWMORPH
دلاميس	NEWMORPH
دلاية	دَلّايَة
دلجة	NEWMORPH
دلغاطان	NEWMORPH
دلوث	NEWMORPH
دلوك	دَلّ,دُلُوك,دَلُوك,دَلْو,دَلَّى
دليجان	NEWMORPH
دم	دَم,دَمّ
دما	دَم,دَمّ
دماح	NEWMORPH
دماط	NEWMORPH
دمامين	NEWMORPH
دمانس	NEWMORPH
دماوند	NEWMORPH
دمح	NEWMORPH
دمخ	NEWMORPH
دمدم	دَمْدَم
دمسيس	NEWMORPH
دمشق	دِمَشْق
دمقرات	NEWMORPH
دمقش	NEWMORPH
دمقلة	NEWMORPH
دمما	دَمَّم
دمندان	NEWMORPH
دمنش	NEWMORPH
دمنهور	دَمَنْهُور
دمنو	NEWMORPH
دمون	NEWMORPH
دمياط	دُمْياط
دميانة	NEWMORPH
دميرة	دَمِيرَة
دمينة	دَمِي-َ,دَمَّى
دمينكة	NEWMORPH
دن	دان-ِ
دنا	دَنا,دان-ِ
دنباوند	NEWMORPH
دنجوية	NEWMORPH
دندانقان	NEWMORPH
دندرة	NEWMORPH
دندنة	دَنْدَن
دنديل	NEWMORPH
دنقلة	دُنْقُلَه
دنن	NEWMORPH
دنوة	دُنُوّ,دَنَّى,دَنا
دنيسر	NEWMORPH
دهجية	NEWMORPH
دهدايه	NEWMORPH
دهر	دَهْر
دهران	NEWMORPH
دهروط	NEWMORPH
دهستان	NEWMORPH
دهشور	دَهْشُور
دهقان	دِهْقان
دهك	دَهَك-َ
دهلك	دَهْلَك
دهنا	دَهَن,دُهْن,دَهْن,دَهَّن
دهنخيرجان	NEWMORPH
دوار	دُوار,دُوّار,دَوّار
دواف	NEWMORPH
دوان	NEWMORPH
دوبان	NEWMORPH
دوة	NEWMORPH
دودان	NEWMORPH
دوران	دَوَران,دَوْر
دورق	دَوْرَق
دورقة	دَوْرَق
دورقستان	NEWMORPH
دوريست	NEWMORPH
دوسر	NEWMORPH
دوسركان	NEWMORPH
دوعن	NEWMORPH
دوغان	NEWMORPH
دوقة	دُوقَة,دُوق
دوقرة	NEWMORPH
دولاب	دُولاب
دولان	دُولان
دولتاباذ	NEWMORPH
دوما	دَوْم,دَوَّم,دُوما
دومان	دُومان
دومة	دَوْم,دَوَّم
دومرية	NEWMORPH
دوميس	NEWMORPH
دومين	NEWMORPH
دون	دُونَ,دَوَّن,دُون
دونة	دُونَ,دَوَّن,دُون
دونق	NEWMORPH
دوين	دَوِي-َ,دَوَّى,دَوَى-ِ
دياف	NEWMORPH
ديالة	NEWMORPH
ديالى	NEWMORPH
ديبور	NEWMORPH
ديزك	NEWMORPH
ديسان	NEWMORPH
ديسقة	NEWMORPH
ديشان	دِيشان
ديصا	NEWMORPH
ديلم	NEWMORPH
ديلمان	NEWMORPH
ديلمستان	NEWMORPH
ديلمي	NEWMORPH
ديماس	دِيماس
ديمرت	NEWMORPH
ديمرتيان	NEWMORPH
ديمس	NEWMORPH
ديناراباذ	NEWMORPH
دينور	NEWMORPH
ديوان	دِيوان
ديوانجه	NEWMORPH
ديورة	NEWMORPH
ديوقان	NEWMORPH
ذاذيخ	NEWMORPH
ذاقن	NEWMORPH
ذاقنة	NEWMORPH
ذباب	ذُباب
ذبل	ذابِل,ذَبْل,ذَبَل
ذبوب	NEWMORPH
ذبيان	ذُبْيان
ذخكث	NEWMORPH
ذخيرة	ذَخِيرَة
ذخينوى	NEWMORPH
ذراة	ذَرَى-ِ,ذَرَى,ذَرا,ذُرْوَة,ذَرّ,ذَرَّى
ذراح	ذُرّاح
ذراعان	ذِراع
ذربان	ذَرِب
ذرة	ذَرَّة,ذُرَة,ذَرّ
ذرعينة	NEWMORPH
ذرو	ذَرْو
ذروان	NEWMORPH
ذروة	ذَرْو,ذَرا,ذُرْوَة,ذَرّ,ذَرَّى
ذرود	NEWMORPH
ذريح	NEWMORPH
ذعاط	NEWMORPH
ذفران	NEWMORPH
ذقان	NEWMORPH
ذلقامان	NEWMORPH
ذمار	ذِمار
ذمرمر	NEWMORPH
ذموران	NEWMORPH
ذمون	NEWMORPH
ذمى	ذَمّ,ذِمِّيّ,ذَمِي-َ
ذنب	ذَنْب,ذَنَب
ذنبان	ذَنَب
ذنبة	ذَنْب,ذَنَب
ذهبان	NEWMORPH
ذهوط	NEWMORPH
ذهيوط	NEWMORPH
ذوال	NEWMORPH
ذورة	NEWMORPH
ذوفة	NEWMORPH
ذياد	ذِياد
ذيال	NEWMORPH
ذيالة	NEWMORPH
ذيبدوان	NEWMORPH
ذيمون	NEWMORPH
رابات	رابَّة
رابة	راب-ِ,راب,رابَّة,رابّ
رابخ	NEWMORPH
رابغ	رابِغ
رابغة	رابِغ
راتج	NEWMORPH
راجل	راجِل
راخ	راخِي
رادس	NEWMORPH
راذان	NEWMORPH
راران	NEWMORPH
رازاباذ	NEWMORPH
رازان	NEWMORPH
رازكان	NEWMORPH
راسب	راسِب
راسة	رَأْس
راسك	رَأْس
راشت	راش
راشتينان	NEWMORPH
راطية	NEWMORPH
راعب	راعِب
راغسرسنة	NEWMORPH
راغن	NEWMORPH
راف	NEWMORPH
راكة	NEWMORPH
راكس	NEWMORPH
راكسة	NEWMORPH
رالان	NEWMORPH
رام	رامِي,رام-ِ,رام
راماشاه	NEWMORPH
رامان	NEWMORPH
رامة	رام-ِ,رام
رامتين	NEWMORPH
رامجرد	NEWMORPH
رامح	رامِح
رامران	NEWMORPH
رامس	NEWMORPH
رامش	NEWMORPH
رامشهرستان	NEWMORPH
رامشين	NEWMORPH
رامن	NEWMORPH
رامني	رام-ِ,رام
رامهرمز	NEWMORPH
راموسة	رامُوس
رامي	رامِي
راميثن	NEWMORPH
رانني	ران-ِ
رانوناء	NEWMORPH
راهص	NEWMORPH
راهط	NEWMORPH
راور	NEWMORPH
راوسان	NEWMORPH
راون	NEWMORPH
راونج	NEWMORPH
راوند	راوَنْد
راونسر	NEWMORPH
راوية	راوِي
رايان	NEWMORPH
راية	رَأْي,رايَة
رائس	NEWMORPH
رائع	رائِع
رباب	رَباب
رباح	رُبّاح
رباع	رُباع,رَبْع,رَبّاع
ربب	رَبَّب
ربخ	NEWMORPH
ربذ	NEWMORPH
ربوة	رِبْوَة,رَبْوَة,رَبْو,رَبَّى,رَبا
ربيخن	NEWMORPH
ربيعة	رَبِيعَة,رَبِيع
ربيق	NEWMORPH
رتم	رَتَم-ِ,رَتَم-َ
رجا	رَجاء,رَجّ,رَجا
رجام	رُجْمَة
رجان	NEWMORPH
رجل	رَجُل,رَجَّل,رِجْل,رَجِل-َ
رجم	رُجْمَة,رَجَّم,رَجْم,رَجَم
رجمان	NEWMORPH
رجيج	NEWMORPH
رجيع	رَجِيع
رجينة	رَجِي-َ
رحا	NEWMORPH
رحاب	رِحاب
رحايا	رَحّاي
رحب	رُحْب,رَحُب,رَحَب,رَحَّب,رَحْب,رَحِب-َ
رحبة	رَحْبَة,رُحْب,رَحَب,رَحَّب,رَحْب
رحبى	رُحْب,رَحَب,رَحْب
رحرحان	NEWMORPH
رحقان	NEWMORPH
رحيات	NEWMORPH
رحية	رَحَى
رحيضة	NEWMORPH
رخ	رُخّ,رَخّ
رخاء	رَخاء,رُخاء
رخام	رُخام
رخج	NEWMORPH
رخره	NEWMORPH
رخش	NEWMORPH
رخشيوذ	NEWMORPH
رخم	رَخَم,رَخَّم,رَخُم
رخمان	NEWMORPH
رخمة	رَخَم,رَخَّم
رخيم	رَخِيم
رخينون	NEWMORPH
رداع	NEWMORPH
ردعان	NEWMORPH
ردفان	رِدْف
ردفة	رَدِف-َ,رِدْف,رَدَف
ردم	رَدَّم,رَدْم,رَدَم
ردمان	NEWMORPH
رذام	NEWMORPH
رذان	NEWMORPH
رزام	NEWMORPH
رزبيط	NEWMORPH
رزجاه	NEWMORPH
رزم	رَزَم,رِزْمَة
رزماباذ	NEWMORPH
رزماز	NEWMORPH
رزمان	NEWMORPH
رزه	رَزَّة,رَزّ,رُزّ
رزيق	رَزِيق
رستاق	رُسْتاق
رستغفر	NEWMORPH
رستغفن	NEWMORPH
رستقباذ	NEWMORPH
رستماباذ	NEWMORPH
رستمكويه	NEWMORPH
رسكن	NEWMORPH
رشاطة	NEWMORPH
رشتان	NEWMORPH
رشيد	رَشِيد
رشين	NEWMORPH
رصاغ	NEWMORPH
رصاف	رَصّاف
رصفة	رَصَّف,رَصَف,رَصِف,رَصْف
رضاء	رِضاء
رضام	NEWMORPH
رضوى	NEWMORPH
رعان	رَعْن
رعبان	NEWMORPH
رعل	NEWMORPH
رعم	NEWMORPH
رعن	رَعُن,راع,رَعْن,رَعَن,راع-ِ
رعين	رَعَى-َ
رغاط	NEWMORPH
رغافة	NEWMORPH
رغال	NEWMORPH
رغباء	NEWMORPH
رغبان	NEWMORPH
رغمان	NEWMORPH
رغوان	NEWMORPH
رغوة	رَغْوَة,رَغَّى,رَغا
رغيمان	NEWMORPH
رفح	رَفَح
رفرف	رَفْرَف
رفنية	NEWMORPH
رقادة	رُقاد
رقد	راقِد,رَقْد,رَقَّد,رَقَد
رقصت	رَقَص,رَقَّص
رقم	رَقَّم,رَقْم,رَقَم
رقن	رَقْن,راق-ِ,راق
رقوبل	NEWMORPH
رك	رَكّ,رَكّ-ِ
ركاء	NEWMORPH
ركاح	NEWMORPH
ركانة	NEWMORPH
ركبان	NEWMORPH
ركضة	رَكْضَة,رَكَض
ركك	رَكّ
ركلة	رَكْل,رَكَل
ركن	رُكْن,رَكِن-َ,رَكَن
ركوبة	رُكُوب,رَكُوب
ركيح	NEWMORPH
رم	رَمّ-ِ,رَمّ
رما	رَمّ-ِ,رَمّ
رماح	رَمّاح,رُمْح
رماخ	NEWMORPH
رمادان	NEWMORPH
رمادة	رَماد
رماع	NEWMORPH
رماغ	NEWMORPH
رمان	رُمّان
رمجار	NEWMORPH
رمح	رُمْح,رَمَح-َ
رمشة	رَمَش-ُِ,رَمَش,رِمْش,رَمْشَة
رمطة	NEWMORPH
رمع	NEWMORPH
رمكان	NEWMORPH
رمم	رَمَّم,رِمَّة
رمي	رَمْي,رَمَى-ِ,رَمّ
رميا	رَمْي,رَمَى-ِ
رميان	NEWMORPH
رميتان	رَمْيَة
رميص	NEWMORPH
رميلة	رُمَيْلَة
رنان	رَنّان
رنبويه	NEWMORPH
رنة	رَنّ-ِ,ران-ِ,رَنَّة
رند	NEWMORPH
رندة	رَنْدَة
رندورد	NEWMORPH
رنوم	NEWMORPH
رنية	NEWMORPH
رهاط	رَهْط
رهاوة	NEWMORPH
رهبا	رَهَب,رَهَّب,رَهِب-َ
رهجان	NEWMORPH
رهط	رَهَط-َ,رَهْط
رهنان	رَهْن
رهنة	رَهَن-َ,رَهْن
رهوة	رَها,رَهْو
رهوط	NEWMORPH
رهوى	رَهْو
رؤاف	NEWMORPH
رؤام	NEWMORPH
روانير	NEWMORPH
رواوة	NEWMORPH
رؤب	NEWMORPH
روبا	رُوب,رَوْب,رَوَّب
روبانجاه	NEWMORPH
روبنج	NEWMORPH
روتنك	NEWMORPH
روثان	NEWMORPH
روثة	رَوْث
روحا	رَوَّح,رُوح,رَوْح
روحة	رَوَّح,رَوْحَة,رُوح,رَوْح
روحين	NEWMORPH
رودس	رُودُس
روذان	NEWMORPH
روذبار	NEWMORPH
روذدشت	NEWMORPH
روذراور	NEWMORPH
روذفغكد	NEWMORPH
روذك	NEWMORPH
روذه	NEWMORPH
روس	رُوس,رُوسِيّ,رَوَّس
روستقباذ	NEWMORPH
روسيس	NEWMORPH
روشان	NEWMORPH
روضتان	رَوْضَة
روطة	NEWMORPH
روق	رَوْق,رَوَّق
رولان	رُولان
رومان	رُومان
رومة	رَوْم,رُوم,رُوما
رونات	NEWMORPH
روناش	NEWMORPH
رؤيا	رُؤَى
رويان	رَوِيّ
روية	رَوِيّ,رَوِيَّة
رؤية	رُؤْيَة
رؤيتان	رُؤْيَة
رويدشت	NEWMORPH
روين	رَوَى-ِ,رَوَّى
رويندز	NEWMORPH
ريا	رَيّاً,رَيّ
رياح	رَيّاح,رِيح
رياع	NEWMORPH
رئام	NEWMORPH
ريان	رِيان,رَيّان
رية	رِئَة,رَيّ
ريث	NEWMORPH
ريحاء	NEWMORPH
ريحان	رَيْحان,رَيِّح
ريخ	NEWMORPH
ريخشن	NEWMORPH
ريدان	NEWMORPH
ريدة	رَوْد
ريذمون	NEWMORPH
ريسوت	NEWMORPH
ريسون	NEWMORPH
ريشان	NEWMORPH
ريشهر	NEWMORPH
ريعان	رَيْعان
ريغ	NEWMORPH
ريكنج	NEWMORPH
ريكنز	NEWMORPH
رئم	رَئِم-َ,رِئْم
ريمان	NEWMORPH
ريمة	رَيَّم,رِيمَة,رِئْم,رِيم
ريو	رِيُو
ريودد	NEWMORPH
ريودى	NEWMORPH
ريوذ	NEWMORPH
ريورثون	NEWMORPH
ريوقان	NEWMORPH
ريونج	NEWMORPH
ريوند	NEWMORPH
زابل	NEWMORPH
زابلستان	NEWMORPH
زابن	NEWMORPH
زابيا	NEWMORPH
زابيان	NEWMORPH
زاحد	NEWMORPH
زاذان	NEWMORPH
زاذقان	NEWMORPH
زاذك	NEWMORPH
زاذيك	NEWMORPH
زار	زار
زارجان	NEWMORPH
زاريان	NEWMORPH
زاشت	NEWMORPH
زاعورة	NEWMORPH
زاغرسوسن	NEWMORPH
زاغونى	زاغ,زاغ-ِ
زافون	NEWMORPH
زاقف	NEWMORPH
زالق	NEWMORPH
زام	زام
زاميثن	NEWMORPH
زاميثنة	NEWMORPH
زامين	NEWMORPH
زاور	NEWMORPH
زاوطا	NEWMORPH
زاوه	NEWMORPH
زباب	NEWMORPH
زباد	زَبْدِيَّة,زَباد
زبارا	NEWMORPH
زبالة	زَبّال,زُبالَة
زبان	NEWMORPH
زبانى	زُبانَى
زبد	زُبْدَة,زُبْد,زَبَد,زَبَّد
زبدان	NEWMORPH
زبدة	زُبْدَة,زُبْد,زَبَد,زَبَّد
زبدقان	NEWMORPH
زبراء	NEWMORPH
زبران	NEWMORPH
زبطرة	NEWMORPH
زبغدوان	NEWMORPH
زبنة	زَبُون
زبوية	NEWMORPH
زبية	زُبْيَة
زبيد	زُبَيْد
زبيدان	NEWMORPH
زبيلاذان	NEWMORPH
زبين	NEWMORPH
زجاج	زُجاج,زُجّ,زَجّاج
زجي	أَزَجّ,زَجَّى,زُجّ
زجيج	NEWMORPH
زحك	NEWMORPH
زحيرية	NEWMORPH
زحيف	NEWMORPH
زخ	NEWMORPH
زخة	زَخَّة
زخم	زَخَم,زَخِم-َ,زَخِم,زَخَم-َ
زخمان	زَخِم
زخيخ	NEWMORPH
زرا	زَرّ,زِرّ
زراباذ	NEWMORPH
زرارة	NEWMORPH
زرافات	زَرافَة
زراوة	NEWMORPH
زراوند	NEWMORPH
زربة	زَرِب-َ,زَرَّب
زرجين	NEWMORPH
زرخش	NEWMORPH
زرد	زَرَد
زردنا	زَرَد
زرزا	NEWMORPH
زرزم	NEWMORPH
زرفامية	NEWMORPH
زرق	زَرَق,زَرِق-َ,زَرْق,زَرَق-ِ,أَزْرَق
زرقان	NEWMORPH
زركران	NEWMORPH
زركون	NEWMORPH
زرم	NEWMORPH
زرمان	NEWMORPH
زرنج	NEWMORPH
زرنجرى	NEWMORPH
زرند	NEWMORPH
زرندر	NEWMORPH
زرنروذ	NEWMORPH
زرنكرى	NEWMORPH
زرنوج	NEWMORPH
زرنوق	NEWMORPH
زرنيخ	زِرْنِيخ
زرهون	NEWMORPH
زرود	زَرَد
زروديزه	NEWMORPH
زريران	NEWMORPH
زريق	زُرَيْق
زشك	NEWMORPH
زعبة	NEWMORPH
زعبل	NEWMORPH
زعر	زَعِر
زعريماش	NEWMORPH
زغابة	NEWMORPH
زغاوة	NEWMORPH
زغر	زَغَر-َ
زغرتان	NEWMORPH
زغموا	NEWMORPH
زغندان	NEWMORPH
زغوان	NEWMORPH
زفا	زَفّ,زَفّ-ِ
زفتا	زِفْت,زَفَّت,زَفّ,زَفّ-ِ,زَفَّة
زقوقا	NEWMORPH
زكان	NEWMORPH
زكت	زَكَّى,زَكا
زكرام	NEWMORPH
زكية	زَكِيّ,زَكِي-َ
زلالة	زُلال
زلفة	زَلَف,زَلَّف,زُلْفَة
زلم	زَلَم
زلول	NEWMORPH
زم	زَمّ
زماخير	NEWMORPH
زماراء	NEWMORPH
زمان	زَمان
زمخشر	NEWMORPH
زمزم	زَمْزَم
زملق	NEWMORPH
زملكا	NEWMORPH
زملكان	NEWMORPH
زمنداور	NEWMORPH
زمهر	زَمْهَر
زميخ	NEWMORPH
زناته	زانِي
زنانير	زُنّار
زنبر	NEWMORPH
زنبق	زَنْبَق
زنج	زَنْج
زنجان	NEWMORPH
زند	زِنَد,زَنْد
زندان	NEWMORPH
زندة	زِنَد,زَنْد
زندجان	NEWMORPH
زندخان	NEWMORPH
زندرامش	NEWMORPH
زندرميثن	NEWMORPH
زندروذ	NEWMORPH
زندنه	NEWMORPH
زندورد	NEWMORPH
زندينا	NEWMORPH
زنق	زَنَقَة,زَنَق-ِ,زَنَّق
زنقب	NEWMORPH
زنيم	زَنِيم
زها	زَها
زهام	NEWMORPH
زهبوط	NEWMORPH
زهدم	NEWMORPH
زهلول	NEWMORPH
زهمان	زَهِم
زهو	زَهْو,زُهُوّ
زو	NEWMORPH
زوابي	NEWMORPH
زواخ	NEWMORPH
زواط	NEWMORPH
زوالقنج	NEWMORPH
زواني	زَوَى-ِ,زَوَّى,زُوان,زانِيَة
زواوة	NEWMORPH
زوبلة	NEWMORPH
زوخة	NEWMORPH
زور	أَزْوَر,زَوَر,زُور,زَوْر,زَوَّر
زوراء	أَزْوَر
زورابذ	NEWMORPH
زورة	زَوَر,أَزْوَر,زَوْر,زُور,زَوْرَة,زَوَّر
زوزا	NEWMORPH
زوزان	NEWMORPH
زوزن	NEWMORPH
زوش	NEWMORPH
زولاب	NEWMORPH
زولاه	زَوَّل
زوم	زُوم,زَوَّم
زون	NEWMORPH
زويل	NEWMORPH
زويلة	NEWMORPH
زوين	زَوَى-ِ,زَوَّى
زيادان	NEWMORPH
زيادباذ	NEWMORPH
زيتان	زَيْت
زيد	زَيْد,زَيَّد
زيدان	زَيْدان
زيداون	NEWMORPH
زيرباذ	NEWMORPH
زيركج	NEWMORPH
زيزاء	NEWMORPH
زيغدوان	NEWMORPH
زيق	زِيق,زَيَّق
زيكون	NEWMORPH
زيلع	NEWMORPH
زيلوش	NEWMORPH
زيمر	NEWMORPH
زيمران	NEWMORPH
زئنة	NEWMORPH
سابراباذ	NEWMORPH
سابروج	NEWMORPH
سابس	باس,بَسّ
سابور	بَوَّر,بار
ساتيدما	NEWMORPH
ساجر	جار,أَجار,أَجْرَى,جَرَى-ِ,جَرّ,أَجَرّ
ساجو	ساجِي,جَوِي-َ
ساحوق	حاق,حَوَّق
ساركون	NEWMORPH
ساروان	NEWMORPH
ساروق	رَوَّق,راق
سارونية	NEWMORPH
ساري	وَرَى-ِ,رَأَى-َ,سارِي,سارّ
سارية	سارِيَة,وَرَى-ِ,سارِي,سارّ
سازة	زُهِي-َ,أَزْهَى,زَها
ساسان	NEWMORPH
ساسكون	NEWMORPH
ساسنجرد	NEWMORPH
ساسي	NEWMORPH
ساعدة	عَدّ,عَدَّى,ساعِدَة,أَعْدَى,أَعاد,ساعَد,عَدا,وَعَد-ِ,عاد,ساعِد,أَعَدّ
ساعير	أَعار,عار-ِ,عَيَّر
ساغرج	NEWMORPH
سافردز	NEWMORPH
ساق	ساقِي,ساق,وَقَى-ِ
ساقطة	ساقِطَة,قَطّ,ساقِط
ساكبدياز	NEWMORPH
سالحين	NEWMORPH
سالم	سالَم,لام,سالِم,لَمّ,أَلام
سالوس	لاس
سام	سامّ,سام,سامِي
سامان	سامّ
سامراء	سامَرّاء
سامين	سامَى,سامّ
سان	وَنَى-ِ,سان
سانجن	NEWMORPH
سانقان	NEWMORPH
سانواجرد	NEWMORPH
سانيز	NEWMORPH
ساهم	وَهَم-ِ,ساهَم,هام-ِ,هَمّ,أَهَمّ,هَما,ساهِم
ساهوق	NEWMORPH
ساو	ساو
ساوكان	NEWMORPH
ساوه	وَهِي-َ,أَوْهَى
ساوين	ساوَى
سائبة	سائِب,أَبّ
ساية	NEWMORPH
سائر	وَأَر,سائِر
سبا	سَبّ
سباب	سِباب,سَبّاب
سباح	سابِح,سَبّاح
سبارى	سِبار
سباق	سابِق,سِباق,سَبّاق
سبال	سَبَلَة
سبت	سَبّ,ساب-ِ,سِبِتّ,سَبَى-ِ,سَبْت,سَبَت
سبتة	سَبّ,ساب-ِ,سَبْتَة,سُبَّة,سِبِتّ,سَبَّة,سَبَى-ِ,سَبْت,سَبَت
سبج	سَبَج
سبد	NEWMORPH
سبذان	NEWMORPH
سبذيون	NEWMORPH
سبر	سَبَر,سَبْر,سِبار
سبراة	سَبَر
سبران	NEWMORPH
سبرة	سَبَر,سَبْر,سِبار
سبرت	سَبَر
سبرنى	سَبَر
سبرينة	NEWMORPH
سبسطية	NEWMORPH
سبسير	NEWMORPH
سبعان	سُبْع,سَبْع
سبعين	سُبْع,سَبْع,سَبْعُون
سبك	سَبّ,سَبَّك,سَبْك,سَبَك-ُِ
سبل	سَبِيل,سَبَل,سَبَّل
سبلات	NEWMORPH
سبلان	NEWMORPH
سبلل	NEWMORPH
سبللة	NEWMORPH
سبن	ساب-ِ
سبنج	NEWMORPH
سبه	سَبّ,سُبَّة,سَبَّة,سَبَه
سبو	NEWMORPH
سبوحة	سَبُوح
سبورقان	NEWMORPH
سبوك	سَبّ,سَبَى-ِ
سبيبة	سَبِيب
سبية	سَبْي,سَبِيّ
سبيذغك	NEWMORPH
سبير	NEWMORPH
سبيرى	NEWMORPH
سبيطلة	NEWMORPH
سبيع	NEWMORPH
ستيفغنه	NEWMORPH
ستيكن	سِتّ
ستين	سِتُّون,سِتّ
سجا	سَجا
سجار	NEWMORPH
سجاس	NEWMORPH
سجبان	NEWMORPH
سجز	NEWMORPH
سجستان	NEWMORPH
سجسيجان	NEWMORPH
سجكان	NEWMORPH
سجلة	سِجِلّ,سَجَّل
سجلماسة	NEWMORPH
سجلين	سِجِلّ
سجوان	NEWMORPH
سجين	سَجَّى,سَجِين
سحام	سُحام
سحامة	سُحام
سحبل	NEWMORPH
سحطة	NEWMORPH
سحلين	NEWMORPH
سحنة	سَحْنَة,سَحَن-َ,ساح-ِ,ساح
سحول	NEWMORPH
سحيل	NEWMORPH
سحيم	سُحَيْم,سَحِيم
سخا	سَخا
سخاخ	NEWMORPH
سخال	سَخْلَة
سخام	سُخام
سخبر	NEWMORPH
سخنة	سَخَّن,سَخَن,سُخْن,ساخ-ِ,سَخِن-َ
سدد	سَدَّد,سَدَد,سُدَّة
سدر	سِدْر,سَدِر-َ
سدوم	سَدُوم
سدين	سَدَّى
سديور	NEWMORPH
سذرجان	NEWMORPH
سذور	NEWMORPH
سر	سُرّ,سِرّ,سَرّ
سرا	سُرّ,سِرّ,سَرّ
سراء	سَرّاء
سرابيط	NEWMORPH
سراسكبهر	NEWMORPH
سراو	NEWMORPH
سراوع	NEWMORPH
سربا	سَرِب-َ,سُرْبَة,سَرَب,سَرَّب,سِرْب
سربار	NEWMORPH
سربان	سَرَب,سِرْب
سربخ	NEWMORPH
سربرد	NEWMORPH
سربزه	NEWMORPH
سربط	NEWMORPH
سرت	سِرْت,سَرَى-ِ,سار-ِ,سَرَّى,سَرّ
سرتة	سَرَى-ِ,سَرَّى,سار-ِ,سُرَّة,سَرّ
سرج	سَرَج-َ,سَرَّج,سِراج,سَرْج
سرجة	سَرَج-َ,سَرَّج,سِراج,سَرْج
سرجهان	NEWMORPH
سرح	سَرَح-َ,سَرَّح,سَرِح-َ
سرحة	سَرَح-َ,سَرَّح,سَرِح-َ
سرخاباذ	NEWMORPH
سرخس	سَرْخَس
سرخك	NEWMORPH
سرخكت	NEWMORPH
سردانية	NEWMORPH
سردد	NEWMORPH
سردر	NEWMORPH
سردروذ	NEWMORPH
سردن	سَرَد,سَرَّد
سردوس	NEWMORPH
سرر	سَرَّر,سُرَّة
سرسن	NEWMORPH
سرسنا	NEWMORPH
سرع	سَرَّع,سَرُع,سُرْع
سرغ	NEWMORPH
سرغامرطا	NEWMORPH
سرف	سَرَف
سرفقان	NEWMORPH
سرق	سَرَق-ِ,سَرَّق
سرقة	سَرِقَة,سَرَق-ِ,سارِق,سَرَّق
سرقسطة	سَرَقُسْطَة
سرقوسة	NEWMORPH
سرك	سِرْك,سُرّ,سِرّ,سَرّ
سركان	NEWMORPH
سركث	NEWMORPH
سرماج	NEWMORPH
سرمارى	NEWMORPH
سرمد	سَرْمَد
سرمقان	NEWMORPH
سرمين	NEWMORPH
سرنة	سار-ِ
سرنجا	NEWMORPH
سرنداد	NEWMORPH
سرنديب	سَرَنْدِيب
سرندين	NEWMORPH
سرنو	NEWMORPH
سرو	سَرْو
سروان	NEWMORPH
سروج	سَرْج
سرور	سُرُور
سروس	NEWMORPH
سروستان	NEWMORPH
سروع	NEWMORPH
سروعة	NEWMORPH
سريا	سِرِّيّ,سَرِيّ,سَرَّى,سَرَى-ِ,سُرِّيّ
سرياقوس	NEWMORPH
سريجان	NEWMORPH
سرير	سَرِير
سريش	NEWMORPH
سريعة	سَرِيع
سرين	سَرَى-ِ,سَرَّى
سطرا	سَطْر,سَطَّر,سَطَر
سطيف	سَطِيف
سعد	سَعْد,سَعِد-َ
سعر	سَعَر-َ,سُعْر,سَعَّر,سِعْر,سَعِير
سعوى	NEWMORPH
سعيا	سَعَى-َ,سَعْي
سعيداباذ	NEWMORPH
سعير	سَعِير
سغدان	NEWMORPH
سفا	NEWMORPH
سفار	NEWMORPH
سفاقس	NEWMORPH
سفال	NEWMORPH
سفان	سَفّان
سفر	سَفَر,سَفَر-ِ,سَفَّر,سِفْر,سُفْرَة
سفرادن	NEWMORPH
سفرمرطى	NEWMORPH
سفع	سُفْعَة,سَفْع,سَفَع-َ
سفوان	NEWMORPH
سفوى	NEWMORPH
سفيان	سُفْيان
سفير	سَفِير
سفيرة	سَفِير
سقار	NEWMORPH
سقام	سَقِيم,سَقام
سقبا	NEWMORPH
سقر	سَقَر
سقران	NEWMORPH
سقرمى	NEWMORPH
سقروان	NEWMORPH
سقطرى	NEWMORPH
سقف	سَقْف,سَقَّف
سقمان	NEWMORPH
سقيا	سَقَى-ِ,سَقْي
سقية	سَقْي
سقيدنج	NEWMORPH
سكاء	أَسَكّ
سكاب	NEWMORPH
سكاك	سَكّ
سكاكة	NEWMORPH
سكان	سُكّان,سَكّان,ساكِن
سكبيان	NEWMORPH
سكجكث	NEWMORPH
سكدة	NEWMORPH
سكر	سَكِر-َ,سَكَّر,سُكْر,سُكَّر
سكران	سَكْران
سكش	NEWMORPH
سكلكند	NEWMORPH
سكن	سَكَّن,سَكَن,ساك
سكندان	NEWMORPH
سلا	سَلّ,سَلا,سِلّ
سلاب	سَلّاب,سِلاب
سلاح	سِلاح
سلاطح	سُلاطِح
سلام	سَلّام,سَلام
سلامان	سَلام
سلبة	سَلْب,سَلَب,سِلاب
سلح	سَلَّح,سَلْح,سَلَح-َ
سلحين	NEWMORPH
سلسل	سَلْسَل
سلسلان	NEWMORPH
سلطوح	NEWMORPH
سلطيس	NEWMORPH
سلع	سَلْع,سِلْعَة,سَلِع-َ
سلعان	NEWMORPH
سلعوج	NEWMORPH
سلغوس	NEWMORPH
سلم	سُلَّم,سَلَّم,سَلِم-َ,سِلْم
سلماس	NEWMORPH
سلمان	سُلَّم,سَلْمان
سلمانان	NEWMORPH
سلمسين	NEWMORPH
سلمقان	NEWMORPH
سلمنت	NEWMORPH
سلمى	سِلْمِيّ,سُلَّم,سَلْمَى,سِلْم
سلمي	سُلَّم,سِلْمِيّ,سَلْمَى,سِلْم
سلمية	سِلْمِيّ,سُلَّم
سلوان	سِلْوان,سُلْوان
سلوطح	NEWMORPH
سلوق	NEWMORPH
سلوقية	سَلُوقِيّ
سلوى	سَلْوَى
سلى	سَلّ,سَلِي-َ,سَلَّى,سِلّ
سليع	NEWMORPH
سليقية	NEWMORPH
سليم	سَلِيم
سليماناباذ	NEWMORPH
سلينة	سَلِي-َ,سَلَّى
سماءة	سَماء
سمادير	سُمْدُور
سماطة	سِماط
سمال	NEWMORPH
سمان	سَمّان
سمانة	سَمّان,سَمانَة
سماهيج	NEWMORPH
سمائم	سَمُوم
سمخراط	NEWMORPH
سمدان	NEWMORPH
سمديسة	NEWMORPH
سمر	أَسْمَر,سَمَر,سَمُر,سَمَّر
سمران	NEWMORPH
سمرطول	NEWMORPH
سمرقند	سَمَرْقَنْد
سمسطا	NEWMORPH
سمسم	سِمْسِم
سمعان	سِمْعان
سمك	سُمْك,سَمّ,سَمَك,سَمَّك
سمكين	NEWMORPH
سملوط	NEWMORPH
سمن	سَمَّن,سِمَن,سُمُّن,سَمْن,سَمِن-َ,سام
سمنان	NEWMORPH
سمنة	سَمَّن,سِمْنَة,سِمَن,سُمُّن,سَمْن,سام
سمنت	سَمَّن,سَمِن-َ,سَمْنَت
سمنجان	NEWMORPH
سمنجور	NEWMORPH
سمندر	سَمَنْدَر
سمندو	NEWMORPH
سمندور	NEWMORPH
سمنطار	NEWMORPH
سمنقان	NEWMORPH
سمنك	سَمَّن,سِمَن,سُمُّن,سَمْن,سام
سمنود	NEWMORPH
سمنية	NEWMORPH
سمنين	NEWMORPH
سمهر	NEWMORPH
سمهوط	NEWMORPH
سمورة	سَمُّور
سمويل	NEWMORPH
سمى	سُمِّيّ,سَمّ,سَمَّى,سَمِيّ
سمي	سُمِّيّ,سَمّ,سَمَّى,سَمِيّ
سميا	سُمِّيّ,سَمَّى,سَمِيّ
سمية	سُمِّيّ,سُمِّيَّة,سَمِيّ
سميجن	NEWMORPH
سميحة	سَمِيح
سمير	سَمِير
سميراء	NEWMORPH
سميران	سَمِير
سميرة	سَمِير,سَمِيرَة
سميرم	NEWMORPH
سميساط	NEWMORPH
سمين	سَمَّى
سنا	سِنّ,سَنَى,سَنا,سَنّ
سناء	سَناء
سناباذ	NEWMORPH
سناج	سِناج
سناجية	NEWMORPH
سناروذ	NEWMORPH
سنام	سَنام
سنان	سِنان,سِنّ,أَنَى-ِ,سَنّان
سنباذة	NEWMORPH
سنباذين	NEWMORPH
سنباط	NEWMORPH
سنبان	أَبان
سنبلان	سُنْبُل
سنبلة	سُنْبُلَة,سُنْبُل,بَلّ,بَلّ-ِ,بَلِه-َ,بَلا,أَبال,بال,بَلِي-َ,أَبَلّ,وَبَل-ِ,أَبْلَى
سنبو	NEWMORPH
سنبوس	باس
سنبيل	أَبال
سنترية	NEWMORPH
سنج	سَنْجَة,سِنْجَة
سنجاباذ	NEWMORPH
سنجار	جارَى,أَجار
سنجان	جانَى
سنجبذ	جَبَذ-ِ
سنجبست	NEWMORPH
سنجة	سَنْجَة,سِنْجَة,جَهِي-َ
سنجديزه	NEWMORPH
سنجروذ	NEWMORPH
سنجفين	NEWMORPH
سنجل	جَلا,أَجْلَى,جَلَى-ِ,جال,جَلّ-ِ,جَلَّى,أَجال,أَجَلّ
سنح	سَنَح-َ,سُنْح,وَحَى-ِ
سنحار	أَحار,حار-َ
سنحان	NEWMORPH
سند	سَنَّد,سِنْد,سَنَد,وَدَى-ِ
سندابل	NEWMORPH
سنداد	NEWMORPH
سندان	أَدان,دانَى,سَنْدان
سندبايا	NEWMORPH
سندبلس	NEWMORPH
سندة	دَهِي-َ,دَهَّى,دَهَى-َ,سَنَّد,سِنْد,سَنَد,وَدَى-ِ
سندفا	NEWMORPH
سندمون	NEWMORPH
سندور	دار,دَوَّر
سنكباث	NEWMORPH
سنكديزه	NEWMORPH
سننة	نَها,وَنَى-ِ,سَنَن,سُنَّة,نَهَى-ِ,أَنْهَى,سَنَّن,سَنّ
سنهور	هار,هَوَّر
سنوان	NEWMORPH
سنومة	NEWMORPH
سنيح	NEWMORPH
سنير	NEWMORPH
سنيرين	NEWMORPH
سنيق	NEWMORPH
سنيكة	NEWMORPH
سنين	سَنَّى,سِنّ,سَنَة
سنينيا	NEWMORPH
سهام	سِهام,سَهْم
سهبى	سُهْب
سهر	سُهَر,سَهَر,سَهِر-َ
سهرج	NEWMORPH
سهرورد	NEWMORPH
سهرياج	NEWMORPH
سهفنة	NEWMORPH
سهل	سَهَّل,سَهُل,سَهْل
سهلة	سَهَّل,سَهْل
سهو	سَهْو
سهواج	NEWMORPH
سهوان	سَهْوان
سهوة	سَهْوَة,سَهْو
سهي	NEWMORPH
سهيل	سُهَيْل
سواء	سَواء
سواج	NEWMORPH
سوادمة	NEWMORPH
سواديزه	NEWMORPH
سوار	سارِيَة,سِوار
سوارق	NEWMORPH
سواع	NEWMORPH
سواكن	سَوَّى,سِوَى,سَكَنَة
سوان	سانِيَة
سوانة	NEWMORPH
سوب	NEWMORPH
سوبخ	NEWMORPH
سوبرنى	NEWMORPH
سوبلا	NEWMORPH
سوتخن	NEWMORPH
سوذانخ	NEWMORPH
سورا	سُورَة,سَوَّر,سُور,سِوار
سوراء	NEWMORPH
سوراب	NEWMORPH
سورة	سُورَة,سَوَّر,سُور,سِوار,سَوْرَة
سورستان	NEWMORPH
سورمين	NEWMORPH
سورنجين	NEWMORPH
سوريان	سُورِيّ
سورية	سُورِيا,سُورِيّ
سورين	NEWMORPH
سوسة	سُوسَة,سُوس
سوسقان	NEWMORPH
سوسنجرد	NEWMORPH
سوسية	سُوس
سوفة	سَوَّف
سوقة	سَوَّق,سُوق,سَوْق,سُوقَة
سولاف	NEWMORPH
سولان	NEWMORPH
سولة	سَوَّل
سونايا	NEWMORPH
سونج	NEWMORPH
سوهاي	NEWMORPH
سوى	سَوَّى,سِوَى,سَوِيّ,سَوِي-َ
سويس	سُوَيْس
سويقة	سُوَيْق,سَوِيق
سويمرة	NEWMORPH
سوينج	NEWMORPH
سياث	NEWMORPH
سياح	سَيّاح,سائِح
سيار	سَيّار
سيارى	سَيّار
سيان	سِيان,سِيّ,أَنَى-ِ
سياورد	NEWMORPH
سيب	سِيب,سَيَّب
سيبان	أَبان
سيبية	NEWMORPH
سية	وَهَى-ِ
سيتكين	NEWMORPH
سيج	سَيَّج
سيح	سَيَّح,وَحَى-ِ
سيحاط	أَحاط
سيحان	NEWMORPH
سيحون	وَحَى-ِ
سيداباذ	NEWMORPH
سير	سِيرَة,سَيْر,سَيَّر,وَرَى-ِ,رَأَى-َ
سيراف	NEWMORPH
سيراوند	NEWMORPH
سيرجان	رَجّ
سيركث	NEWMORPH
سيروان	NEWMORPH
سيزج	زَجَّى,أَزْجَى,زَجّ,زَجا
سيسبان	سَبّ,سَيْسَبان
سيسجان	NEWMORPH
سيسر	سَرَى-ِ,سَرَّى,سار-ِ,أَسار,أَسَرّ,سَرّ,أَسْرَى
سيسمراباذ	NEWMORPH
سيسية	NEWMORPH
سيفذنج	NEWMORPH
سيكث	كَثّ-ِ
سيكجسكث	NEWMORPH
سيل	سَيَّل,سَيْل,وَلِي-ِ
سيلا	سَيَّل,سَيْل
سيلان	سِيلان,سَيَلان,أَلان
سيلة	سَيَّل,لَهِي-َ,وَلِه-َِ,سَيْل,لَها,أَلْهَى,وَلِي-ِ,سَيْلَة,لَهَّى
سيلحون	لَحّ-َ,أَلَحّ,لَحا,لَحَى
سيلون	وَلِي-ِ,لَوَّن
سينا	سِين,سِيناء
سينان	سِين
سينيرين	NEWMORPH
سينيز	NEWMORPH
سيهى	وَهَى-ِ
سيوستان	NEWMORPH
سيوط	وَطَّى
شاباي	شابّ
شابة	شابَّة,شابّ,شابَه,شاب
شابجن	NEWMORPH
شابراباذ	NEWMORPH
شابران	NEWMORPH
شابرخواست	NEWMORPH
شابرزان	NEWMORPH
شابرنج	NEWMORPH
شابسه	NEWMORPH
شابك	شابّ,شاب
شابهار	NEWMORPH
شابور	NEWMORPH
شاتان	شاة
شاجب	NEWMORPH
شاجن	NEWMORPH
شاحط	شاحِط
شاذبهمن	NEWMORPH
شاذشابور	NEWMORPH
شاذفيررز	NEWMORPH
شاذقباذ	NEWMORPH
شاذكان	NEWMORPH
شاذمانه	NEWMORPH
شاذمهر	NEWMORPH
شاذهرمز	NEWMORPH
شاذوان	NEWMORPH
شاذياخ	NEWMORPH
شار	شارِي
شارع	شارِع
شارقة	شارِق,شارِقَة
شارك	شارَك
شارمساح	NEWMORPH
شاس	شاس
شاش	شاش
شاط	شاط-ِ
شاطبة	NEWMORPH
شافيا	شافِي
شاقة	شاق,شاقّ
شاقرة	NEWMORPH
شاقرد	NEWMORPH
شاكر	شاكِر,شاكَر
شالها	شال-ِ,شال
شالوس	NEWMORPH
شامات	شامَة
شامة	شامَة
شامستيان	NEWMORPH
شامكان	NEWMORPH
شاموخ	NEWMORPH
شاهي	شاهِي
شاوان	NEWMORPH
شاوخران	NEWMORPH
شاوذار	NEWMORPH
شاوشاباذ	NEWMORPH
شاوشكان	NEWMORPH
شاوغر	NEWMORPH
شاوغز	NEWMORPH
شاوكت	NEWMORPH
شب	شَبّ-ِ,شَبّ
شباب	شَبّ,شَباب
شبابة	شَبّ,شَباب,شَبّابَة
شباح	NEWMORPH
شباس	NEWMORPH
شباعة	شَبْعان
شبام	شِبام
شبداز	NEWMORPH
شبر	شَبَّر,شِبْر,شَبَر
شبراذق	NEWMORPH
شبرانة	NEWMORPH
شبرب	NEWMORPH
شبرت	شَبَّر,شَبَر
شبرقان	NEWMORPH
شبرم	NEWMORPH
شبرمان	NEWMORPH
شبشير	NEWMORPH
شبطران	NEWMORPH
شبك	شُبُق,شَبّ-ِ,شَبَّك,شَبّ,شَبَك-ِ
شبلاد	NEWMORPH
شبلان	شِبْل
شبوة	شَبّ-ِ,شَبّ
شبورقان	NEWMORPH
شبيث	NEWMORPH
شبيلش	NEWMORPH
شبيوط	NEWMORPH
شتان	شَتّان,شَتّ
شتر	شَتَر-ِ
شتنا	شَتّ-ِ,شَتّ
شجا	شَجاً,شَجّ,شَجا
شجار	شِجار
شجان	NEWMORPH
شجعات	NEWMORPH
شجعى	NEWMORPH
شجنة	شَجَّن,شَجَن
شجوة	شَجْو,شَجّ,شَجَّى,شَجا
شحا	شَحّ,شُحّ
شحاط	NEWMORPH
شحشبو	NEWMORPH
شحوة	NEWMORPH
شخاخ	شَخّ
شخب	شَخَب-َُ
شخصان	شَخْص
شدخ	شَدَّخ,شَدَخ-َ,شَدْخ
شدموه	NEWMORPH
شدن	شَدَن,شاد-ِ
شدوان	NEWMORPH
شدونبة	NEWMORPH
شذا	شَذّ,شَذّ-ُِ,شَذاً
شذونة	NEWMORPH
شرا	شَرّ,شَرّ-َ
شراعة	شَرّاعَة,شِراع
شراف	NEWMORPH
شراوة	NEWMORPH
شرب	شَرِب-َ,شُرْب,شَرَّب
شربب	NEWMORPH
شربة	شَرِب-َ,شُرْب,شَرَّب,شَرْبَة
شربث	NEWMORPH
شرج	شَرَج
شرجة	شَرَج
شرز	NEWMORPH
شرطيش	NEWMORPH
شرع	شَرْع,شَرَّع,شَرَع,شَرَع-َ
شرعب	NEWMORPH
شرغ	NEWMORPH
شرغيان	NEWMORPH
شرف	شَرَف,شَرَّف,شَرُف
شرفانية	NEWMORPH
شرفدد	NEWMORPH
شرفدن	NEWMORPH
شرق	شَرِق-َ,شَرْق,شَرَق
شرقيون	شَرْقِيّ
شرك	شِرْك,شَرّ,شَرِك-َ,شَرَك
شرماح	NEWMORPH
شرمة	شَرَم-ِ,شَرْم
شرمساح	NEWMORPH
شرمغول	NEWMORPH
شرمقان	NEWMORPH
شرملة	NEWMORPH
شرواذ	NEWMORPH
شروان	NEWMORPH
شرورى	شَرّ
شروز	NEWMORPH
شروط	شَرْط
شروم	شَرْم
شرونة	NEWMORPH
شروين	NEWMORPH
شري	شِرَى,شَرّ,شَرَى-ِ,شَرْي
شريان	شِرْيان
شريب	شِرِّيب,شَرِيب
شريج	NEWMORPH
شريش	NEWMORPH
شريط	شَرِيط
شريفة	شَرِيف
شريق	NEWMORPH
شريون	NEWMORPH
شزن	NEWMORPH
شس	NEWMORPH
شستق	NEWMORPH
شسعى	NEWMORPH
ششانة	NEWMORPH
ششلة	NEWMORPH
شط	شَطّ-ُِ,شَطّ
شطا	شَطّ-ُِ,شَطّ
شطاب	NEWMORPH
شطاطير	NEWMORPH
شطب	شَطَب,شَطْب,شَطَّب
شطفورة	NEWMORPH
شطنان	شَطْن
شطنوف	NEWMORPH
شطون	NEWMORPH
شطيب	NEWMORPH
شظا	NEWMORPH
شظي	شَظِي-َ
شظيات	NEWMORPH
شظيف	NEWMORPH
شعارى	شِعار,شِعارِيّ
شعب	شِعْب,شَعْب,شُعْبَة,شَعَّب
شعباء	NEWMORPH
شعبان	شَعْب,شَعْبان
شعبة	شِعْب,شِعْبَة,شَعْب,شُعْبَة,شَعَّب
شعبعب	NEWMORPH
شعبى	شِعْب,شُعَبِيّ,شَعْب,شَعْبِيّ,شُعْبَة
شعبين	شَعْب
شعث	شَعِث-َ,شَعِث,شَعْث,شَعَّث
شعر	شِعْر,شَعَر,شَعْر
شعران	NEWMORPH
شعرى	شِعْر,شِعْرِيّ,شَعْر,شَعْرِيّ
شعف	NEWMORPH
شعفان	NEWMORPH
شعفين	NEWMORPH
شعلان	NEWMORPH
شعوب	شَعْب
شعوف	NEWMORPH
شعيب	شُعَيْب,شَعِيب
شعيبة	شَعِيب
شغب	شَغَب-َ,شَغِب,شَغَب
شغبغب	NEWMORPH
شغبى	شَغِب,شَغَب
شغزى	NEWMORPH
شغف	شَغِف,شَغَف-َ,شَغَف
شغور	شُغُور
شفار	شَفْرَة
شفدد	NEWMORPH
شفر	شِفْر,شَفْر
شفراء	NEWMORPH
شفرعم	NEWMORPH
شفرقان	NEWMORPH
شفية	NEWMORPH
شق	شَقّ,شِقّ
شقار	NEWMORPH
شقان	شَقّ,شِقّ
شقبان	NEWMORPH
شقبانارية	NEWMORPH
شقة	شَقّ,شَقَّة,شُقَّة,شِقّ
شقر	أَشْقَر,شَقِر-َ,شَقَر
شقران	NEWMORPH
شقرة	أَشْقَر,شَقَر,شُقْرَة
شقرى	أَشْقَر,شَقَر
شقص	NEWMORPH
شقلاباذ	NEWMORPH
شقورة	NEWMORPH
شقوق	شَقّ
شقى	شَقِيّ,شَقّ,شَقِي,شِقّ
شكان	NEWMORPH
شكت	شَكّ,شاك,شَكا
شكر	شَكَر,شُكْر
شكستان	شَكِس
شكلان	شَكْل
شكى	شَكّ,شِيك
شلاثا	NEWMORPH
شلالتين	NEWMORPH
شلام	NEWMORPH
شلانجرد	NEWMORPH
شلاهط	NEWMORPH
شلب	NEWMORPH
شلج	NEWMORPH
شلجيكث	NEWMORPH
شلطيش	NEWMORPH
شلم	NEWMORPH
شلمبة	NEWMORPH
شلمغان	NEWMORPH
شلنبة	NEWMORPH
شلوبينية	NEWMORPH
شلوذ	NEWMORPH
شلوقة	NEWMORPH
شلول	NEWMORPH
شلون	NEWMORPH
شلير	NEWMORPH
شماء	أَشَمّ
شماخي	NEWMORPH
شماخير	NEWMORPH
شماليل	شُمْلُول
شمام	شَمّام
شمجلة	NEWMORPH
شمخ	شَمَخ-َ
شمس	شَمْس,شَمَّس,شَمِس-َ,شَمَس
شمسان	NEWMORPH
شمسانية	NEWMORPH
شمشاط	NEWMORPH
شمشكازاد	NEWMORPH
شمطة	شَمِط-َ,شَمَط,أَشْمَط
شمكور	NEWMORPH
شمل	شَمْل,شَمِل-َ,شَمَل
شمن	شام-ِ
شمنتان	NEWMORPH
شمنصير	NEWMORPH
شمهار	NEWMORPH
شمونت	NEWMORPH
شميديزه	NEWMORPH
شميرام	NEWMORPH
شميران	NEWMORPH
شميرف	NEWMORPH
شميسى	شُمَيْسِيّ
شميط	شُمَيْط
شميكان	NEWMORPH
شميلان	NEWMORPH
شميهن	شَمِّيّ
شن	شان-ِ,شَنّ
شنا	شان-ِ,شَنّ
شناباذ	NEWMORPH
شناص	NEWMORPH
شناصير	NEWMORPH
شنان	NEWMORPH
شنائك	شانِئ
شنتجالة	NEWMORPH
شنترة	NEWMORPH
شنترين	NEWMORPH
شنتغنش	NEWMORPH
شندوخ	NEWMORPH
شندويد	NEWMORPH
شنذان	NEWMORPH
شنزوب	NEWMORPH
شنشت	NEWMORPH
شنط	شَنْطَة
شنظب	NEWMORPH
شنقنيرة	NEWMORPH
شنوءة	NEWMORPH
شنودة	شِنُودَة
شنوكة	NEWMORPH
شنية	NEWMORPH
شهارة	NEWMORPH
شهاق	شَهِيق
شهبة	أَشْهَب,شَهَب,شِهاب
شهد	شَهِد-َ
شهراباذ	NEWMORPH
شهرابان	NEWMORPH
شهرزور	NEWMORPH
شهرستان	NEWMORPH
شهرقباذ	NEWMORPH
شهشدف	NEWMORPH
شهميل	NEWMORPH
شهنان	NEWMORPH
شهوان	شَهْوان
شوا	شَوّا
شوابة	شابَّة
شواجن	NEWMORPH
شواحط	NEWMORPH
شواحطة	NEWMORPH
شواش	شاوُش,شَواش
شواص	NEWMORPH
شوال	شُوال,شَوّال
شوان	NEWMORPH
شوحطان	NEWMORPH
شوخنان	NEWMORPH
شوذبان	NEWMORPH
شور	شَوَّر
شوراب	NEWMORPH
شوران	NEWMORPH
شوزن	NEWMORPH
شوش	شَوَّش,أَشْوَش
شوشة	شَوَّش,شُوشَة,أَشْوَش
شوط	شَوْط
شوطان	شَوْط
شوطى	شَوْط
شوعر	NEWMORPH
شوق	شَوَّق,شَوْق
شوقب	NEWMORPH
شوك	شَوَّك,شَوِك,شَوْك
شوكان	شَوِك,شَوْك
شولاء	NEWMORPH
شومان	NEWMORPH
شوميا	NEWMORPH
شونة	شَوَّن,شُونَة
شويس	NEWMORPH
شي	شَيّ
شيا	شَيّ
شيان	NEWMORPH
شيب	أَشْيَب,شَيْب,شَيَّب
شيبة	أَشْيَب,شَيْب,شَيَّب,شَيْبَة,شِيبَة
شيبيين	NEWMORPH
شيحان	شِيحان
شيخ	شَيْخ
شيخان	شَيْخ
شير	شِير
شيراز	شِيراز
شيرز	NEWMORPH
شيرس	NEWMORPH
شيركه	NEWMORPH
شيرين	شيرين
شيز	NEWMORPH
شيزر	NEWMORPH
شيطب	NEWMORPH
شيطر	NEWMORPH
شيعان	NEWMORPH
شيفان	NEWMORPH
شيفيا	NEWMORPH
شيقر	NEWMORPH
شيلمان	شِيلْمان
شيلى	شِيلا,شِيلِيّ
شينور	NEWMORPH
شينون	NEWMORPH
شيي	شَيّ
صا	NEWMORPH
صابرنيشا	NEWMORPH
صاحات	NEWMORPH
صاحة	صاح-ِ
صاحتان	NEWMORPH
صاد	صاد-ِ,صاد
صادر	صادِر,صادَر
صار	صار,صارِي
صارات	NEWMORPH
صارة	صار,صارَّة
صارخة	صارِخ
صاري	صارِي
صاع	صاع
صاغان	NEWMORPH
صاغرة	صاغِر
صاغرج	NEWMORPH
صاف	صافِي
صالحان	صالِح
صالف	NEWMORPH
صالقان	NEWMORPH
صامغان	NEWMORPH
صان	صان
صانقان	NEWMORPH
صاهك	NEWMORPH
صاهل	صاهِل
صايد	NEWMORPH
صائر	NEWMORPH
صايرتاقنا	NEWMORPH
صائف	NEWMORPH
صباب	صَبّاب
صباح	صُباح,صَباح
صبار	NEWMORPH
صبارح	NEWMORPH
صبح	صُبْح,صَبَّح
صبحة	صُبْح,صَبَّح
صبر	صَبَّر,صَبَر-ِ,صَبْر
صبران	NEWMORPH
صبرة	صُبْرَة,صَبْرَة,صَبَّر,صَبْرَه,صَبْر
صبغاء	NEWMORPH
صبوائيم	NEWMORPH
صبيا	صَبِيّ,صَبِي-َ,صَبَّى
صبيب	صَبِيب
صبيرة	صُبَّيْر
صبيغ	NEWMORPH
صبيغاء	NEWMORPH
صحا	صَحّ-ِ,صَحا
صحار	صَحارِي
صحصح	NEWMORPH
صحن	صَحْن,صاح-ِ
صحير	NEWMORPH
صخد	NEWMORPH
صخراباذ	NEWMORPH
صخيرات	NEWMORPH
صداء	NEWMORPH
صدار	صِدار
صداصد	NEWMORPH
صدد	صَدَد
صدر	صَدَّر,صَدْر,صَدَر
صدف	صُدْفَة,صَدَف-ِ,صَدَف
صدفورة	NEWMORPH
صدقة	صَدَقَة,صِدْق,صَدَّق
صدي	صَدَى,صَدّ,صَدِي-َ,صَدَّى
صديان	NEWMORPH
صديق	صَدِيق,صِدِّيق
صراد	صُرّاد
صرار	صَرّار
صراف	صَرّاف
صرام	NEWMORPH
صربة	صِرْب,صِرْبِيّ
صرخ	صَرَخ
صرخد	NEWMORPH
صرخيان	NEWMORPH
صرداح	NEWMORPH
صرر	NEWMORPH
صرصر	صَرْصَر,صُرْصُر
صرعون	NEWMORPH
صرعينا	صَرْعِيّ
صرفة	صِرْف,صَرْف,صَرَف-ِ,صَرَّف
صرفندة	NEWMORPH
صرمنجان	NEWMORPH
صرواح	NEWMORPH
صريفون	NEWMORPH
صريفين	NEWMORPH
صرين	NEWMORPH
صطفورة	NEWMORPH
صعادى	صَعّاد
صعائد	NEWMORPH
صعائق	NEWMORPH
صعب	صَعْب,صَعُب
صعد	صَعِيد,صَعِد-َ,صَعَّد
صعدة	صَعِيد,صَعِد-َ,صَعْدَة,صَعَّد
صعران	NEWMORPH
صعفوق	NEWMORPH
صعق	صَعَق-َ,صَعَق,صَعِق-َ
صعنبى	NEWMORPH
صغانيان	NEWMORPH
صغدبيل	NEWMORPH
صغر	صَغَّر,صِغَر,صَغُر
صغران	NEWMORPH
صغوا	صَغِي-َ,صَغا,صَغْو
صف	صَفّ
صفار	صَفار
صفاوة	NEWMORPH
صفت	صَفا,صَفَّى,صَفّ
صفح	صَفَح-َ,صَفْح,صَفَّح
صفد	صَفَد,صَفَّد
صفر	صِفْر,صَفَر-ِ,أَصْفَر,صَفَر,صَفَّر
صفنة	صَفَن-ِ,صَفَن
صفوان	صَفْوان
صفور	NEWMORPH
صفورية	NEWMORPH
صفية	صَفّ,صَفِيّ,صَفِيَّة
صفين	صَفَّى,صَفّ,صَفِين
صفينة	صَفَّى,صَفِين
صقر	صَقْر
صقلب	NEWMORPH
صقلية	صِقِلِّيّ
صكا	صَكّ
صلاح	صالِح,صَلاح
صلاصل	NEWMORPH
صلب	صُلْب,صَلَب-ِ,صَلُب,صَلَّب,صَلْب
صلخب	NEWMORPH
صلدد	NEWMORPH
صلصل	صَلْصَل
صلفيون	NEWMORPH
صلوب	NEWMORPH
صماخ	صِماخ
صماد	صِماد
صمالو	NEWMORPH
صمعر	NEWMORPH
صمعل	NEWMORPH
صمكيك	NEWMORPH
صمينات	NEWMORPH
صنار	NEWMORPH
صناف	NEWMORPH
صنبر	NEWMORPH
صنبو	NEWMORPH
صنجة	صِنْجَة,صَنْج
صنجيلة	NEWMORPH
صندد	NEWMORPH
صندل	صَنْدَل
صندوداء	NEWMORPH
صنع	صَنَّع,صَنْع,صُنْع,صَنَع-َ
صنعاء	صَنْعاء
صنعان	NEWMORPH
صنعة	صَنْعَة,صَنَّع,صَنْع,صُنْع,صَنَع-َ
صنف	صِنْف,صَنَّف
صنم	صَنَم
صنيبعات	NEWMORPH
صها	NEWMORPH
صهاب	NEWMORPH
صهباء	أَصْهَب
صهر	صَهْر,صِهْر,صَهَر-َ
صهرتاج	NEWMORPH
صهرجت	NEWMORPH
صهيا	NEWMORPH
صهيد	صَهِيد
صهيون	صَهْيُون
صوار	صارِي
صؤار	NEWMORPH
صواعق	صاعِقَة
صوام	NEWMORPH
صوبا	صَوْب,صَوَّب
صوت	صَوَّت,صَوْت
صور	صَوَّر,صُورَة,صُور
صوران	NEWMORPH
صورة	صَوَّر,صُورَة
صورى	صُوَرِيّ,صُورَة
صوعة	NEWMORPH
صول	صَوْل,صُول
صومح	NEWMORPH
صومحان	NEWMORPH
صوناخ	NEWMORPH
صيبون	NEWMORPH
صيخد	NEWMORPH
صيد	صَيْد
صيداء	صَيْداء
صيدنايا	NEWMORPH
صيدوح	NEWMORPH
صير	صَيَّر
صيرة	صَيَّر
صيعير	NEWMORPH
صيغ	صِيغَة,صاغ
صيقاة	NEWMORPH
صيلة	NEWMORPH
صيلع	NEWMORPH
صيمرة	NEWMORPH
صيمكان	NEWMORPH
صيمور	NEWMORPH
صيهاء	NEWMORPH
صيهد	NEWMORPH
صيهون	NEWMORPH
ضابىء	NEWMORPH
ضاجع	ضاجَع
ضاحك	ضاحِك
ضارب	ضارِب,ضارَب
ضارج	NEWMORPH
ضاس	NEWMORPH
ضان	NEWMORPH
ضب	ضَبّ-ِ,ضَبّ
ضباء	NEWMORPH
ضباب	ضَباب
ضباح	NEWMORPH
ضبار	NEWMORPH
ضباعة	ضَبْع
ضبة	ضَبَّة,ضَبّ-ِ,ضَبّ
ضبح	ضَبَح-َ
ضبع	ضَبْع
ضبعان	NEWMORPH
ضبوعة	NEWMORPH
ضبيعة	NEWMORPH
ضجن	NEWMORPH
ضجنان	NEWMORPH
ضحا	ضَحا
ضحن	NEWMORPH
ضحيان	NEWMORPH
ضدا	ضِدّ
ضداد	NEWMORPH
ضدنى	NEWMORPH
ضدوان	NEWMORPH
ضديان	ضِدِّيّ
ضراح	NEWMORPH
ضراعة	ضَرْع,ضَراعَة
ضراف	NEWMORPH
ضربة	ضَرَب,ضَرَّب,ضَرْب,ضَرْبَة
ضربيط	NEWMORPH
ضرعاء	NEWMORPH
ضرغام	ضَرْغَم
ضرغد	NEWMORPH
ضروان	NEWMORPH
ضروة	ضَرّ,ضَرَّى,ضِرْو
ضري	ضَرَّى,ضُرِّيّ,ضِرّ
ضريبة	ضَرِيبَة
ضرية	ضُرِّيّ,ضُرِّيَّة
ضريحة	ضَرِيح
ضعاضع	NEWMORPH
ضغاط	NEWMORPH
ضغن	ضَغِن-َ,ضِغْن,ضَغِن
ضفر	ضَفْر,ضَفَر
ضفوى	NEWMORPH
ضفير	NEWMORPH
ضفيرة	ضَفِيرَة
ضلضلة	NEWMORPH
ضلع	ضَلَّع,ضَلَع-َ,ضِلْع,ضَلْع
ضلفع	NEWMORPH
ضليلى	NEWMORPH
ضمار	NEWMORPH
ضمر	ضُمْر,ضَمَر
ضمرة	ضُمْر
ضمير	ضَمِير
ضميم	ضَمِيم
ضنك	ضَنُك,ضَنّ,ضَنّ-َ,ضَنْك
ضنكان	NEWMORPH
ضها	NEWMORPH
ضهيد	NEWMORPH
ضوت	ضَوَى-ِ
ضوران	NEWMORPH
ضويحك	NEWMORPH
ضيبر	NEWMORPH
ضيم	ضَيْم
ضين	NEWMORPH
ضئيدة	NEWMORPH
طاب	طاب-ِ,طاب
طابان	NEWMORPH
طابة	طابا,طابَة,طاب
طابث	NEWMORPH
طابران	NEWMORPH
طابق	طابِق,طابَق
طاحية	NEWMORPH
طاذ	NEWMORPH
طار	طار-ِ
طاراب	NEWMORPH
طاران	NEWMORPH
طاربند	NEWMORPH
طارف	طارِف
طارق	طارِق
طارنت	NEWMORPH
طاسبندا	NEWMORPH
طاسى	طاس
طاطرى	NEWMORPH
طاعلة	NEWMORPH
طالقان	NEWMORPH
طالقة	طالِق
طاهر	طاهَر,طاهِر
طاووس	طاؤُوس
طايقان	NEWMORPH
طبا	طَبّ,طِبّ
طبب	طَبَّب
طبران	NEWMORPH
طبرستان	NEWMORPH
طبرستران	NEWMORPH
طبرقة	NEWMORPH
طبرك	طَبَر
طبرمين	NEWMORPH
طبرية	طَبَرِيَّة,طَبَرِيّ
طبس	NEWMORPH
طبع	طَبَّع,طَبْع,طَبَع-َ
طبنة	NEWMORPH
طبنذا	NEWMORPH
طبيرة	NEWMORPH
طثرة	NEWMORPH
طثيثا	NEWMORPH
طحا	NEWMORPH
طحاب	NEWMORPH
طحال	طُحال,طِحال
طحطوط	NEWMORPH
طخاران	NEWMORPH
طخارستان	NEWMORPH
طخام	NEWMORPH
طخش	NEWMORPH
طخفة	NEWMORPH
طخورذ	NEWMORPH
طدان	NEWMORPH
طرا	طَرُو,طَرّ-ِ,طَرّ,طُرّ
طرابلس	طَرابُلُس
طرابنش	NEWMORPH
طرابية	NEWMORPH
طراد	طَرّاد,طِراد
طراربند	NEWMORPH
طراز	طِراز
طراق	طارِق
طران	NEWMORPH
طرائف	طَرِيفَة
طرة	طُرَّة,طُرَة,طَرّ-ِ,طَرّ
طرجلة	NEWMORPH
طرحان	NEWMORPH
طرخاباذ	NEWMORPH
طررة	طُرَّة
طرسوس	NEWMORPH
طرسونة	NEWMORPH
طرش	طَرَّش,طَرَش,أَطْرَش,طَرْش,طَرِش-َ
طرشيز	NEWMORPH
طرطانش	NEWMORPH
طرطايش	NEWMORPH
طرطر	طَرْطَر
طرطوانش	NEWMORPH
طرطوس	طَرْطُوس
طرطوشة	NEWMORPH
طرغلة	NEWMORPH
طرف	طَرُف,طَرَف-ِ,طَرَف
طرفة	طَرَف-ِ,طُرْفَة,طَرَف,طَرْفَة,طَرْفاء
طرق	طَرِيق,طَرَق,طَرَّق
طرقلة	NEWMORPH
طركونة	NEWMORPH
طرم	NEWMORPH
طرماج	NEWMORPH
طرميس	NEWMORPH
طرندة	NEWMORPH
طرنيانة	NEWMORPH
طرواخا	NEWMORPH
طرون	طَرُو
طريانة	NEWMORPH
طريثيث	NEWMORPH
طريف	طَرِيف
طريفة	طَرِيف,طَرِيفَة
طزر	NEWMORPH
طزعة	NEWMORPH
طزيان	NEWMORPH
طسفونج	NEWMORPH
طشكر	NEWMORPH
طغامى	طَغام
طفر	طَفَر-ِ,طَفْر
طفراباذ	NEWMORPH
طفرجيل	NEWMORPH
طفيل	NEWMORPH
طل	طَلّ
طلا	طَلّ
طلاة	طَلّ,طَلَى-ِ
طلاح	طَلاح
طلال	طَلال,طَلّ
طلبان	طَلَب
طلبيرة	NEWMORPH
طلح	طَلْح,طَلَح
طلحام	NEWMORPH
طلخاء	NEWMORPH
طلخام	NEWMORPH
طلقان	NEWMORPH
طلمنكة	NEWMORPH
طلموية	NEWMORPH
طلوب	NEWMORPH
طلوبة	NEWMORPH
طلوح	طَلْح
طلياطة	NEWMORPH
طليطلة	طُلَيْطِلَة
طما	طَما,طِمّ,طَمّ
طمار	طُمار
طمام	NEWMORPH
طمر	طَمَر-ِ,طَمْر,طِمِرّ,طِمْر,طَمَّر
طمستان	NEWMORPH
طمية	طَمْي
طميس	NEWMORPH
طمين	طَمَى-ِ
طنان	طُنّ,طَنّان
طنب	طَنَّب,طُنُب,طُنْب
طنبذة	NEWMORPH
طنت	طَنّ
طنتثنا	NEWMORPH
طنج	NEWMORPH
طنجة	طَنْجَة
طنز	NEWMORPH
طنزة	NEWMORPH
طنوبرة	NEWMORPH
طهران	طَهْران
طهرمس	NEWMORPH
طهنة	NEWMORPH
طهنهور	NEWMORPH
طهيان	NEWMORPH
طو	NEWMORPH
طواران	NEWMORPH
طواس	NEWMORPH
طوالة	طَوِيل,طِوالَ,طُوالَة
طوانة	NEWMORPH
طواويس	طاؤُوس
طوة	NEWMORPH
طوخ	NEWMORPH
طود	طَوْد
طور	طَوْر,طَوَّر
طوران	طَوْر
طورق	NEWMORPH
طورك	طَوْر,طَوَّر
طورين	طَوْر
طوس	طَوَّس
طوسان	NEWMORPH
طوسن	طَوَّس
طوطالقة	NEWMORPH
طوعة	طاعَة,طَوَّع
طوغات	NEWMORPH
طولقة	NEWMORPH
طوى	طَوَى,طَوَى-ِ
طويع	NEWMORPH
طويلع	NEWMORPH
طيبة	طِيبَة,طَيَّب,طِيب,طَيِّب
طيخ	NEWMORPH
طيخة	NEWMORPH
طير	طَيَّر,طَيْر
طيرا	طَيَّر,طَيْر
طيرة	طِيرَة,طَيَّر,طَيْرَة,طَيْر
طيزناباذ	NEWMORPH
طيسانية	NEWMORPH
طيسفون	NEWMORPH
طيفور	طَيْفُور
طيفوراباذ	NEWMORPH
طيلسان	طَيْلَسان
طئية	NEWMORPH
ظبة	NEWMORPH
ظبى	ظَبْي,ظَبِي
ظبي	ظَبْي,ظَبِي
ظبيان	ظَبْي
ظبية	ظَبْي,ظَبْيَة
ظراء	NEWMORPH
ظراة	NEWMORPH
ظران	ظِرّان
ظرب	NEWMORPH
ظريب	NEWMORPH
ظريبة	NEWMORPH
ظفار	ظُفار
ظفر	ظَفِر,ظُفُر,ظَفِر-َ,ظَفَر,ظَفَّر
ظفران	ظَفِر,ظُفُر,ظُفْران
ظلال	ظِلّ
ظلامة	ظُلامَة,ظَلّام,ظَلام,ظالِم
ظلم	ظَلَم-َِ,ظُلْم
ظليف	NEWMORPH
ظليلاء	NEWMORPH
ظليم	ظَلِيم
ظهور	ظُهُور
ظير	NEWMORPH
عابد	عابِد
عابدين	عابِد
عابود	NEWMORPH
عاثين	NEWMORPH
عاج	عاج
عاجف	NEWMORPH
عاجنة	NEWMORPH
عادية	عادِي,عادِيّ,عادِيَة
عاذ	عاذ
عاذب	NEWMORPH
عارض	عارَض,عارِض
عارم	عارِم
عارمة	عارِم
عازب	عازِب
عازف	عازِف
عاسم	عاسِم
عاسمين	NEWMORPH
عاشم	NEWMORPH
عاص	عاصِي
عاصم	عاصِم
عاضي	NEWMORPH
عاقر	عاقَر,عاقِر
عاقل	عاقِل
عاقولاء	NEWMORPH
عالج	عالَج
عالز	NEWMORPH
عامر	عامِر
عاموراء	NEWMORPH
عاموص	NEWMORPH
عانات	NEWMORPH
عانة	NEWMORPH
عاند	عانَد
عاندين	NEWMORPH
عانق	عانَق
عاهن	عاهِن
عائد	عائِد
عائذ	NEWMORPH
عائر	NEWMORPH
عائم	عائِم
عباثر	NEWMORPH
عباد	عَبّاد,عابِد,عِباد
عبادان	عَبادان
عباعب	NEWMORPH
عباقر	NEWMORPH
عباقل	NEWMORPH
عبب	NEWMORPH
عبثر	NEWMORPH
عبدان	عَبْد
عبدسي	NEWMORPH
عبدل	NEWMORPH
عبرتا	عَبَر,عَبْرَة,عَبَّر,عِبْرَة
عبرين	NEWMORPH
عبس	عَبَّس,عَبْس,عَبَس-ِ
عبسقان	NEWMORPH
عبعب	NEWMORPH
عبقر	عَبْقَر
عبلة	عَبْل
عبود	عَبُّود
عبوس	عُبُوس
عبية	NEWMORPH
عبيدان	عُبَيْدان
عبيقر	NEWMORPH
عتائد	NEWMORPH
عتك	عَتَك-ِ
عتكان	NEWMORPH
عتل	عَتَل,عَتْل
عتم	عَتَّم,عَتْم,عَتَم-ِ
عتمة	عَتْمَة,عَتَّم,عَتْم,عَتَم-ِ
عتود	NEWMORPH
عتور	NEWMORPH
عتيب	NEWMORPH
عتيد	عَتِيد
عتيك	عَتِيّ,عُتِيّ
عثارى	NEWMORPH
عثاعث	NEWMORPH
عثال	NEWMORPH
عثان	NEWMORPH
عثر	عَثَّر,عَثَر
عثران	NEWMORPH
عثعث	NEWMORPH
عثلب	NEWMORPH
عثلمة	NEWMORPH
عثليث	NEWMORPH
عثمان	عُثْمان
عثمر	NEWMORPH
عثود	NEWMORPH
عثير	عِثْيَر
عجاساء	NEWMORPH
عجالز	NEWMORPH
عجب	عَجِب-َ,عَجَب,عَجَّب
عجرم	عَجْرَم
عجز	عَجْز,عَجِز-َ,عَجُز,عَجَّز
عجس	NEWMORPH
عجلاء	NEWMORPH
عجلان	عَجْلان
عجلة	عَجَّل,عِجْل,عَجَل,عَجِل-َ,عَجَلَة
عجلز	NEWMORPH
عجلزة	NEWMORPH
عجوز	عَجُوز
عجيب	عَجِيب
عداد	عَدّاد,عِداد
عدامة	NEWMORPH
عدان	NEWMORPH
عدفاء	NEWMORPH
عدفان	NEWMORPH
عدم	عَدَم,عَدِم-َ
عدن	عَدْن,عاد
عدنة	عَدْن,عاد
عدوة	عَدّ,عَدَّى,عُدْوَة,عَدا,عَدُوّ,عَدْو
عدولى	عُدُول
عدية	عَدِيّ,عَدِّيَّة
عديد	عَدِيد
عدينة	عَدَّى
عذاة	عَذاة
عذار	عِذار
عذبة	عَذَب-ِ,عَذَّب,عَذْب
عذراء	عَذْراء
عذرة	عُذْرَة,عُذْر,عَذَر-ِ
عذق	عِذْق
عذم	NEWMORPH
عذنون	NEWMORPH
عذيقة	NEWMORPH
عرابة	عَرّاب
عراجين	عُرْجُون
عرار	عَرار
عراعر	NEWMORPH
عراقيب	عُرْقُوب
عران	NEWMORPH
عرب	عَرَّب,عَرَبِيّ
عربات	عَرَبَة
عربان	NEWMORPH
عربايا	NEWMORPH
عربة	عَرَبَة,عَرَّب,عَرَبِيّ
عربسوس	NEWMORPH
عرجموس	NEWMORPH
عردات	NEWMORPH
عردة	NEWMORPH
عرزم	NEWMORPH
عرس	عَرَّس,عُرْس
عرشان	عَرْش
عرصه	عَرَص,عَرْصَة
عرض	عَرَض,عَرَض-ِ,عَرْض,عِرْض,عَرَّض
عرعر	عَرْعَر
عرف	عَرَّف,عَرَف-ِ,عُرْف
عرفات	عَرَفات
عرفان	عِرْفان
عرفة	عَرَفَة,عَرَّف,عَرَف-ِ,عُرْف
عرفجاء	NEWMORPH
عرق	عَرَق,عِرْق,عَرِق-َ,عَرَّق
عرقبة	عَرْقَب,عَرْقَبَة
عرقة	عَرَق,عِرْق,عَرِق-َ,عَرَّق
عرقوة	عَرِق-َ,عَرَّق
عرنان	NEWMORPH
عرنة	عار-َ,عَرِين,عَرَن,عار-ِ
عرندل	NEWMORPH
عرهان	NEWMORPH
عروان	NEWMORPH
عروى	NEWMORPH
عريان	عُرْيان
عريتنات	NEWMORPH
عريجاء	NEWMORPH
عريش	عَرِيش
عريشاء	NEWMORPH
عريض	عَرِيض
عريضة	عَرِيضَة,عَرِيض
عريعرة	NEWMORPH
عريفطان	NEWMORPH
عريق	عَرِيق
عريقة	عَرِيق
عريقية	عَرِيق
عرين	عَرَّى,عَرِين,عَرِي-َ
عرينة	عَرِينَة,عَرَّى,عَرِين
عز	عَزّ-ِ,عِزّ
عزا	عَزا,عَزّ-ِ,عِزّ
عزاز	NEWMORPH
عزان	NEWMORPH
عزرة	عَزَر-ِ,عَزَّر,عَزْر
عزور	NEWMORPH
عزوزا	NEWMORPH
عزويت	NEWMORPH
عزيب	NEWMORPH
عساب	NEWMORPH
عساقيل	عُسْقُول
عسان	NEWMORPH
عسجد	عَسْجَد
عسجر	NEWMORPH
عسجل	NEWMORPH
عسر	عَسَّر,عَسِر,عُسْر,عَسَر,عَسُر
عسعس	عَسْعَس
عسفان	NEWMORPH
عسقلان	عَسْقَل,عَسْقَلان
عسل	عَسَّل,عَسَل
عسلج	عُسْلُج
عسن	NEWMORPH
عسيب	عَسِيب
عشترا	NEWMORPH
عشر	عُشْر,عَشَّر,عَشَر,عَشْر
عشرون	عِشْرُون
عشم	عَشَم,عَشِم-َ
عشهار	NEWMORPH
عشوراء	عاشُوراء
عشورى	عَشُور,عُشْر
عشوزل	NEWMORPH
عشوزن	NEWMORPH
عشيرة	عَشِيرَة,عَشِير
عصار	عُصار,عَصارِي
عصبة	عَصَب-ِ,عَصَب,عَصَبَة,عَصَّب
عصر	عَصَر-ِ,عَصَّر,عَصْر
عصف	عَصَف-ِ,عَصْف
عصفان	NEWMORPH
عصم	عَصْم,عَصَم-ِ,أَعْصَم
عصنصر	NEWMORPH
عصوصر	NEWMORPH
عضدان	عَضُد
عطالة	عَطالَة
عطم	NEWMORPH
عظام	عَظِيم,عَظْم
عظرة	NEWMORPH
عظم	عَظُم,عُظْم,عَظْم,عَظَّم
عظير	NEWMORPH
عفار	عُفار
عفر	عَفَر-ِ,عَفَر,عَفَّر
عفراء	أَعْفَر
عفربلا	NEWMORPH
عفرى	عَفَر
عفرين	عِفْرِين
عفزة	NEWMORPH
عفلان	NEWMORPH
عفلانة	NEWMORPH
عفيصا	NEWMORPH
عقار	عَقار,عَقّار
عقاراء	NEWMORPH
عقبة	عَقِبَ,عُقْب,عَقَب,عَقَّب,عَقَبَة
عقد	عِقْد,عَقْد,عُقْدَة,عَقَّد,عَقَد-ِ
عقدة	عِقْد,عَقْد,عُقْدَة,عَقَّد,عَقَد-ِ
عقرباء	NEWMORPH
عقرقس	NEWMORPH
عقرقوف	NEWMORPH
عقرما	NEWMORPH
عقفان	NEWMORPH
عقل	عِقال,عَقَل-ِ,عَقْل,عَقَّل
عقمة	عَقَّم,عُقْمَة,عُقْم,عَقِيم
عقنة	عاق
عقوقس	NEWMORPH
عقيربا	NEWMORPH
عقيل	عُقَيْل,عَقِيل
عك	عَكّ
عكا	عَكَّة,عَكّ
عكاد	NEWMORPH
عكاش	NEWMORPH
عكاظ	عُكاظ
عكبرا	عِكْبِر
عكة	عَكَّة,عَكّ
عكل	NEWMORPH
عكوتان	NEWMORPH
علاف	عَلَف
علان	عَلّان
علب	عُلْبَة,عَلَّب
علبية	NEWMORPH
علثم	NEWMORPH
علجان	NEWMORPH
علجانة	NEWMORPH
علعال	NEWMORPH
علق	عَلِق,عَلَّق
علقماء	NEWMORPH
علقمة	عَلْقَم,عَلْقَمَة
عللان	NEWMORPH
علمان	عَلَم
علن	عَلَن,عَلِن,عال-ِ,عال
علوس	NEWMORPH
علي	عَلِيّ,عَلَى,عَلَّى
علياباذ	NEWMORPH
عليب	NEWMORPH
عم	عَمّ
عما	عَمّ,عَمّا
عماس	NEWMORPH
عماق	عَمِيق
عمان	عَمّ,عُمان,عَمّان
عماية	عَمايَة
عمايتان	NEWMORPH
عمتا	عَمَّة,عَمّ,عَمَّى
عمدان	NEWMORPH
عمر	عَمَر,عَمُر,عَمَّر,عُمْر,عَمِر-َ,عُمَر
عمران	عُمْران
عمرو	عَمْرو
عمق	عَمَّق,عَمِيق,عَمُق,عُمْق
عمقيان	NEWMORPH
عمقين	NEWMORPH
عمل	عَمِل-َ,عَمَل
عملة	عُمْلَة,عَمِل-َ,عَمَل,عامِل
عملى	عَمَلِيّ,عَمَل
عمواس	NEWMORPH
عمورية	NEWMORPH
عميانس	NEWMORPH
عن	عَن,عَنّ
عناذان	NEWMORPH
عناصر	عُنْصُر
عناق	عِناق,عَناق
عناقان	NEWMORPH
عنان	عِنان,عَنان
عنبان	NEWMORPH
عنبب	NEWMORPH
عنبة	عِنَب
عنة	عُنَّة,عَن
عندل	عَنْدَل
عنز	عَنْز
عنس	عَنَس-ِ
عنصل	عُنْصُل
عنصلاء	NEWMORPH
عنقاء	عَنْقاء
عنقز	NEWMORPH
عنك	عَن
عنكب	NEWMORPH
عنوب	NEWMORPH
عنيبسات	NEWMORPH
عنيزة	عُنَيْزَة
عنيزتين	عُنَيْزَة
عنيق	NEWMORPH
عوادن	NEWMORPH
عوار	عَوار
عوارة	عَوار
عوارض	عارِض
عوارم	NEWMORPH
عوال	عالِيَة
عوالص	NEWMORPH
عوام	عَوّام,عامَّة
عوانة	عَوان
عوائن	NEWMORPH
عوج	عَوَج,عَوَّج,عَوِج-َ,أَعْوَج
عورتا	عَوَّر,عَوْرَة
عورش	NEWMORPH
عوس	NEWMORPH
عوساء	NEWMORPH
عوسجة	عَوْسَج
عوض	عِوَضَ,عِوَض,عَوَّض,عَوَض
عوف	عَوْف
عوق	عَوْق,عَوَّق
عوقة	عَوْق,عَوَّق
عوكلان	NEWMORPH
عوم	عَوْم,عَوَّم
عوهق	NEWMORPH
عوي	عَوَى-ِ
عويج	NEWMORPH
عوير	NEWMORPH
عويرضات	NEWMORPH
عويص	عَوِيص
عيان	عِيان,عَيّان,عَيّ
عيانة	عِيان,عَيّان
عيبان	NEWMORPH
عيبة	عَيْبَة,عَيْب,عَيَّب
عيثة	عَيَّث,عَيْث
عيجاء	NEWMORPH
عيدان	عُود,عِيد
عيذاب	NEWMORPH
عير	عَيْر,عَيَّر
عيساباذ	NEWMORPH
عيسطان	NEWMORPH
عيشان	NEWMORPH
عيقة	NEWMORPH
عيكتان	NEWMORPH
عين	عَيَّن,عَيْن
عينان	عَيْن
عينب	NEWMORPH
عينم	NEWMORPH
عينون	NEWMORPH
عينين	عَيْن
عيهم	عِيّ,عَيّ
عيهوم	NEWMORPH
غاب	غاب-ِ,غابَة
غابة	غابَة
غابر	غابِر
غادة	غادَة
غاف	غافِي
غافر	NEWMORPH
غافط	NEWMORPH
غافق	NEWMORPH
غافل	غافَل,غافِل
غالب	غالَب,غالِب
غامية	غامّ
غان	NEWMORPH
غانة	غانَة
غانظ	NEWMORPH
غانفر	NEWMORPH
غانماباذ	NEWMORPH
غاوة	NEWMORPH
غب	غِبّ,غَبّ-َ,غَبّ
غباء	غَباء
غباغب	NEWMORPH
غبب	غَبَب
غبر	غَبِر,غَبَّر,أَغْبَر,غَبَر
غبيب	NEWMORPH
غبية	غَبِيّ
غبير	NEWMORPH
غثث	NEWMORPH
غجدوان	NEWMORPH
غجساج	NEWMORPH
غدامس	NEWMORPH
غدان	غِدان
غداود	NEWMORPH
غدر	غَدْر,غَدِير,غَدَر-ِ
غدشفرد	NEWMORPH
غدق	غَدِق-َ,غَدِق
غدير	غَدِير
غذقذونة	NEWMORPH
غذم	NEWMORPH
غذوان	NEWMORPH
غراب	غُراب
غرار	غِرار,غَرّار
غراز	NEWMORPH
غراق	NEWMORPH
غران	NEWMORPH
غرب	غَرْب,غَرَّب,غَرَب
غربة	غَرْب,غَرَّب,غَرَب,غُرْبَة
غربنكي	NEWMORPH
غرة	غِرّ,غِرَّة,غَرّ,غُرَّة,أَغَرّ
غرديان	NEWMORPH
غرزة	غَرَز-ِ,غَرْز,غَرَّز
غرسة	غَرْسَة,غَرْس,غَرَس-ِ
غرش	غِرْش
غرشستان	NEWMORPH
غرف	غُرْفَة,غَرَف-ِ
غرفة	غُرْفَة,غَرَف-ِ
غرق	غَرَق,غَرَّق,غَرِق-َ
غرقة	غَرَق,غَرَّق,غَرِق-َ
غرقد	NEWMORPH
غرمى	غُرْم
غرناطة	غَرْناطَة
غرنيطوف	NEWMORPH
غروب	غُرُوب
غرور	غُرُور
غري	غِرّ,غَرَّى,أَغَرّ
غريان	NEWMORPH
غريب	غُرَيْب,غَرِيب
غريف	NEWMORPH
غريفة	NEWMORPH
غزال	غَزّال,غَزال
غزائل	NEWMORPH
غزة	غَزَّة
غزران	NEWMORPH
غزق	NEWMORPH
غزنة	NEWMORPH
غزنيان	NEWMORPH
غزنيز	NEWMORPH
غزنين	NEWMORPH
غزوان	NEWMORPH
غزية	غَزِّيّ
غسان	غَسّان
غسل	غَسَل-ِ,غِسْل,غَسَّل,غُسْل
غشاوة	غِشاوَة
غشب	NEWMORPH
غشدان	NEWMORPH
غشم	غَشَم-ِ,غَشَّم,غَشْم
غشي	غِشّ,غَشّ,غَشْي,غَشِي-َ,غَشَّى
غشيب	NEWMORPH
غشية	غَشْي,غَشِي-َ
غشيد	NEWMORPH
غضا	غَضَى,غَضّ
غضار	NEWMORPH
غضبان	غَضِب,غَضْبان
غضور	NEWMORPH
غضي	غَضَى,غَضّ
غضيان	NEWMORPH
غضيف	NEWMORPH
غطيف	NEWMORPH
غفارة	غَفّار,غِفارَة
غفجمون	NEWMORPH
غفر	غَفْر,غَفَر,غَفَّر
غلاس	NEWMORPH
غلافق	NEWMORPH
غلافقة	NEWMORPH
غلاق	NEWMORPH
غلائل	غِلالَة
غلز	NEWMORPH
غلطان	غَلْطان,غَلَط
غلغل	غَلْغَل
غلفان	NEWMORPH
غلفة	غَلَّف,غُلْفَة,غِلاف
غما	غَمّ
غمازة	غَمّاز,غَمّازَة
غمدان	NEWMORPH
غمر	غَمَر,غَمْر,غَمُر
غمرة	غَمْرَة,غَمَر,غَمْر
غمز	غَمَز-ِ,غَمْز
غملى	NEWMORPH
غمير	NEWMORPH
غميس	غَمِيس
غناج	NEWMORPH
غنادوست	NEWMORPH
غناظ	NEWMORPH
غنثر	NEWMORPH
غنداب	NEWMORPH
غندجان	NEWMORPH
غندوذ	NEWMORPH
غنيمات	NEWMORPH
غوبذين	NEWMORPH
غور	غُور,غَوْر
غورج	NEWMORPH
غورجك	NEWMORPH
غورشك	NEWMORPH
غوره	غَوْر
غوروان	NEWMORPH
غوريان	NEWMORPH
غورين	NEWMORPH
غوزم	NEWMORPH
غوسنان	NEWMORPH
غوشفنج	NEWMORPH
غول	غُول
غولان	NEWMORPH
غولقان	NEWMORPH
غويث	NEWMORPH
غوير	NEWMORPH
غويل	NEWMORPH
غياية	NEWMORPH
غيدان	NEWMORPH
غيزان	NEWMORPH
غيشتى	NEWMORPH
غيطلة	NEWMORPH
غيفة	NEWMORPH
غيق	NEWMORPH
غيقة	NEWMORPH
غيل	غِيل,غَيْل
غيناء	أَغْيَن
غينة	غَيْن,غَيْنَة
فابجان	NEWMORPH
فابزان	NEWMORPH
فابستين	NEWMORPH
فاثور	ثار,ثَوَّر
فاجتمعنا	ٱِجْتَمَع
فاذجان	NEWMORPH
فار	فارّ,وَرَى-ِ,فار,رَأَى-َ,أَر,آر,فَأْر
فاراب	آراب,رابَى,إِرْب,أَراب
فاران	فارّ
فارة	فارِه,رَها,فارّ,وَرَى-ِ,فارَة,فار,رَأَى-َ,آر,فَأْر
فارجك	أَرَج,رَجّ,رَجا,راج,أَرْج,رَجِي-َ,أَرِج
فارد	رَدِي-َ,راد,أَرَدّ,رَدَّى,أَراد,رَدّ,أَرْدَى,وَرَد-ِ
فارزة	أَرَزّ,رَزّ,فارِزَة,رُزّ,أَرْز,راز
فارس	رَسا,رَسَّى,فارِس,أَرْسَى,أَرَس-ِ
فارسجين	NEWMORPH
فارع	أَرْعَى,وَرِع-ِ,راع,فارِع,أَراع,رَعا,راع-ِ,رَعَى-َ
فارفان	NEWMORPH
فارمذ	NEWMORPH
فاروز	فارُوز,راز
فاروق	فارُوق,رَوَّق,راق
فارويه	أَرْوَى,أُرْوِيَّة,رَوَى-ِ,رَوَّى
فارياب	NEWMORPH
فاريانان	NEWMORPH
فاز	فاز,أَزّ
فازر	أَزار,زَرَى-ِ,وَزَر-ِ,أَزْر,أَزَّر,آزَر,زَرّ,أَزَر-ِ,زار,إِزار,أَزْرَى
فاس	أُسّ,آسِي,آس,إِس,فاس
فاشان	NEWMORPH
فاشوق	شَوَّق,شاق
فاشون	شَوَّن
فاضجة	NEWMORPH
فاضح	أَضْحَى,ضَحا,فاضِح,وَضَح-ِ,ضَحَّى,ضَحِي-َ
فاطماباذ	NEWMORPH
فاغ	NEWMORPH
فافان	أَفِين,إِيفان
فاق	فاق,آق,وَقَى-ِ
فاقر	أَقَرّ,قَرّ-َِ,وَقَر-ِ,قَرَى-ِ,قَرا
فاقوس	قَوِس-َ,قَوَّس
فال	إِل,آل,وَلِي-ِ,فال-ِ,فال,ال
فالة	أَلَّه,لَهِي-َ,آل,وَلِه-َِ,لَها,أَلْهَى,وَلِي-ِ,إِلٰه,لَهَّى,آلَة
فالق	فالِق,لَقِي-َ,أَلَق-ِ,أَلَق,أَلْقَى,لاق-ِ
فامية	أُمِّيّ,أَماه,أُمِّيَّة
فامين	أَمِين,آمِين
فاو	أَو,فاو,أُو
فاوة	أَوَّه,وَهِي-َ,أَوْهَى
فايا	أَيّ,آيا
فائد	أَدّ,وَأَد
فائش	NEWMORPH
فب	ب
فتاخ	فَتْخَة
فتاق	تاق,فِتاق
فتق	فَتَق,فَتَّق,فَتْق,وَقَى-ِ
فتك	فَتّ,تَكّ,فَتْك,وَكَى-ِ,فَتَك,فات,تَكّ-ِ
فج	ج,فَجّ
فجكش	NEWMORPH
فحفح	NEWMORPH
فحل	فَحْل,حِلّ,حَلّ-ِ,حَلّ
فحلين	حَلَى,حَلَّى,حَلِي-َ,حَلّ
فخ	خ,فَخّ
فخراباذ	NEWMORPH
فدان	دانِي,دان-ِ,فَدّان
فدك	دَكّ
فديك	دِيك
فذايا	NEWMORPH
فذورد	NEWMORPH
فذيانكث	NEWMORPH
فراب	راب-ِ,راب,رابّ
فراس	رَأْس,راسِي
فراشا	راش,فَرّاش,فِراش
فراشة	راش,فَرّاش,فِراش,فَراشَة
فراص	NEWMORPH
فراض	راض,راضِي
فراغ	راغ,فَراغ
فراغان	NEWMORPH
فراقد	راقِد
فران	ران-ِ,فَرّان
فراهان	NEWMORPH
فراهينان	NEWMORPH
فراوة	NEWMORPH
فربر	NEWMORPH
فربيا	رَبَّى
فربيط	NEWMORPH
فرتاج	رِتاج
فرتنى	فَرَّى,فَرَى-ِ,فار,فَرّ-ِ
فرج	رَجّ,فَرَّج,فَرَج,فَرْج
فرجيا	رَجِي-َ
فرخشا	NEWMORPH
فرخشة	NEWMORPH
فرخوزديزه	NEWMORPH
فردة	فَرْد,رَدَّة,فَرَّد,رَدّ
فردجان	NEWMORPH
فردد	رَدَّد
فردوس	فِرْدَوْس
فردى	رَدِي-َ,فَرْد,رَدَّى,رَدَى,رَدّ,فَرْدِيّ
فرزاذ	NEWMORPH
فرزاميثن	NEWMORPH
فرزن	راز,فَرَز-ِ,رَزُن
فرزين	رَزِين
فرس	فارِسِيّ,فَرَس
فرساباذ	NEWMORPH
فرسان	فارِس,فَرَس,فَرَسان
فرشابور	NEWMORPH
فرشوط	NEWMORPH
فرط	فَرَط,فَرَّط,فَرْط
فرطس	NEWMORPH
فرطسا	NEWMORPH
فرعان	رَعْن,فَرْع
فرغان	فَرِغ
فرغانة	NEWMORPH
فرغليط	NEWMORPH
فرغول	NEWMORPH
فرفقاباذ	NEWMORPH
فرقب	رَقَب
فرقد	رَقْد,راقِد,رَقَّد,رَقَد,فَرْقَد
فرقصة	رَقْصَة,رَقَص,رَقْص,رَقَّص
فرقلس	NEWMORPH
فرقين	رَقَّى,رَقِي-َ
فرك	فَرّ,فَرَّك,فَرْك,رَكّ,فَرَك,فَرّ-ِ,رَكّ-ِ
فركان	NEWMORPH
فرمانيرداباذ	NEWMORPH
فرميشكان	NEWMORPH
فرناباذ	NEWMORPH
فرنة	رَنّ-ِ,ران-ِ,فار,رَنَّة,فُرْن
فرنداباذ	NEWMORPH
فرنداذ	NEWMORPH
فرنكد	NEWMORPH
فرنيفثان	NEWMORPH
فره	فَرِه,فَرّ,فَرّ-ِ
فرهاذان	NEWMORPH
فرهاذجرد	NEWMORPH
فرهان	رِهان,فَرِه
فروات	فَرْوَة
فرواجان	NEWMORPH
فروان	رُوان,فَرّاء
فرياب	NEWMORPH
فرياض	رِياض,رَوْضَة
فريانان	NEWMORPH
فريانة	رِيان,رَيّان
فريث	NEWMORPH
فريرة	NEWMORPH
فريزن	NEWMORPH
فريش	رَيَّش,رِيش
فريق	فَرِيق,رَيِّق,رِيق
فريقات	NEWMORPH
فريم	رَيَّم,رِئْم,رِيم
فرين	فَرَّى,فَرَى-ِ
فز	فَزّ-ِ,ز
فزان	زان-ِ,زانِي,زان
فزح	NEWMORPH
فزرانيا	NEWMORPH
فسا	فَسا
فساران	سارّ
فستجان	جانَى
فستقان	NEWMORPH
فسكرة	سَكِر-َ,سَكْرَة,سَكَّر,سُكْر,سُكَّر
فسنجان	جانَى
فسيل	سَيَّل,سَيْل,فَسِيلَة,وَلِي-ِ
فشال	شال-ِ,شال
فشتجان	NEWMORPH
فشنة	فاش-ِ,شان-ِ,شَنّ
فشيذيزه	NEWMORPH
فصيص	NEWMORPH
فطرس	طِرْس
فطيمة	فَطِيم
فعرى	عُرْوَة,عُرْي,عَرَّى,عَرِي-َ
فعمعم	NEWMORPH
فعن	عَن,عَنّ
فغانديز	NEWMORPH
فغديز	NEWMORPH
فغدين	غَدِي-َ,غَدَّى
فغر	غِرّ,فُغْرَة,غَرّ,فَغَر-َُ,أَغَرّ
فغشت	غَشّ,غَشا,غَشَّى,غُشْت
فغندرة	غُنْدُر,غَنْدَرَة
فغيطوسين	NEWMORPH
فغيفد	NEWMORPH
فقعاء	NEWMORPH
فقير	قِير,فَقِير,قَيَّر
فقيم	قِيمَة,قَيَّم,قَيِّم
فلا	فَلّ,فُلّ,فِيلّا,لا,فَلاً
فلاج	لاجّ
فلاكرد	NEWMORPH
فلام	لام,أُمّ
فلانان	فُلان,أَنان,أَنّان,أَنَى-ِ
فلتوم	تُوم
فلج	لُجّ,لَجّ-َِ,فَلَج-ِ,فَلْج,فَلَج,فَلَّج
فلجة	لُجّ,لَجَّة,لِجَة,فَلْج,فَلَج,فَلَّج
فلجرد	جَرِد,جَرْد
فلخار	NEWMORPH
فلسطين	فِلَسْطِين
فلطاح	فِلْطاح
فلفلان	فُلان
فلق	فَلَق-ِ,فَلَّق,فَلْق
فلك	فَلّ,فُلّ,لِ-,لُكّ,فَلَك,لَكّ
فليج	NEWMORPH
فليجة	جَهِي-َ
فليش	وَشَى-ِ,لَيْش
فنا	فَنّ
فناخره	نَخَر
فنجة	جَهِي-َ
فنجديه	أَجْدَى,نَجْدِيّ
فنجكان	NEWMORPH
فنجكرد	NEWMORPH
فند	نَدّ,نِدّ,فَنَّد,نَدّ-ِ,وَدَى-ِ
فندلاو	NEWMORPH
فندورج	NEWMORPH
فندوين	NEWMORPH
فنديسجان	NEWMORPH
فندين	أَدان,نَدِي-َ,نِدّ,نَدَّى,دان-ِ
فنسجان	NEWMORPH
فنك	نِك,وَكَى-ِ,فَنّ,فَنَك
فنكد	كاد-َ,نَكِد-َ,نَكْد,كاد-ِ,نَكِد,كَدَى-ِ,أَكْدَى,نَكَد,كَدّ,كَدَّى,نَكَّد
فنونى	وَنَّى,وَنِي-َ,نُون,فَنّ,نُونِيّ,فَنِي-َ
فنين	فَنِي-َ
فهرمد	NEWMORPH
فهلفهرة	NEWMORPH
فهلو	NEWMORPH
فهندجان	NEWMORPH
فوة	فُوه
فوتق	NEWMORPH
فود	وَدّ-َ,فَوْد,وُدّ
فوذان	NEWMORPH
فورارد	NEWMORPH
فوران	فَوَران
فورجرد	NEWMORPH
فورفاره	NEWMORPH
فوز	وَزّ,وَزَّة,فَوْز
فوزكرد	NEWMORPH
فوشنج	NEWMORPH
فولو	NEWMORPH
فونكه	NEWMORPH
فويدين	NEWMORPH
في	فِي,ي
فيادسون	NEWMORPH
فياض	فَيّاض
فيجكث	NEWMORPH
فيحان	NEWMORPH
فيحة	وَحَى-ِ
فيد	يَد,وَدَى-ِ
فيدة	دَهِي-َ,دَهَى-َ,دَهَّى,يَد,وَدَى-ِ
فيذوقية	NEWMORPH
فير	وَرَى-ِ,رَأَى-َ
فيروز	فَيْرُوز,راز
فيروزاباذ	NEWMORPH
فيروزان	راز
فيروزرام	NEWMORPH
فيروزسابور	NEWMORPH
فيروزقباذ	NEWMORPH
فيروزكند	NEWMORPH
فيروزكوه	NEWMORPH
فيرياب	NEWMORPH
فيشابور	NEWMORPH
فيشان	NEWMORPH
فيشة	فِيشَة,وَشَى-ِ,فِيش,شاه,شَهَّى,شَوِه-َ,فَيْش
فيشون	وَشَى-ِ,شَوَّن
فيف	وَفَى-ِ
فيفاء	فَيْفاء,أَفاء
فيق	وَقَى-ِ
فيل	فِيل,وَلِي-ِ
فيلان	فِيل,أَلان
فيمان	NEWMORPH
فين	فِين,وَنَى-ِ,يِن
فيوازجان	NEWMORPH
قابس	قابِس
قابون	NEWMORPH
قادس	قادِس
قادم	قادِم
قار	قارِي,قار,قارّ
قارات	قارَّة,قارَة
قارة	قارَّة,قارَة,قار,قارّ
قارز	NEWMORPH
قارض	قارَض,قارِض
قارعة	قارَع,قارِع,قارِعَة
قارغوان	NEWMORPH
قارونية	NEWMORPH
قاسان	NEWMORPH
قاسم	قاسَم,قاسِم
قاسيون	NEWMORPH
قاشان	NEWMORPH
قاشره	NEWMORPH
قاصرة	قاصِر
قاصرين	قاصِر
قاعس	NEWMORPH
قاعون	NEWMORPH
قاف	قاف
قاقون	NEWMORPH
قالس	NEWMORPH
قالع	NEWMORPH
قالوص	NEWMORPH
قاليقلا	NEWMORPH
قامهل	NEWMORPH
قان	قانِئ,قانِي
قانيش	NEWMORPH
قاو	NEWMORPH
قاين	NEWMORPH
قبا	قَبّ,قَبا
قباذق	NEWMORPH
قباذيان	NEWMORPH
قباقب	NEWMORPH
قبال	NEWMORPH
قبان	قَبّان,قَبّ
قبة	قَبَّة,قُبَّة,قَبّ
قبثور	NEWMORPH
قبحاطة	NEWMORPH
قبحان	NEWMORPH
قبدة	NEWMORPH
قبذاق	NEWMORPH
قبر	قَبَر,قَبْر,قُبَّر
قبراثا	NEWMORPH
قبرة	قَبَر,قَبْر,قُبَّر
قبرس	قُبْرُص,قُبْرُس
قبرونيا	NEWMORPH
قبريان	قَبْرِيّ
قبرين	قَبْر
قبش	NEWMORPH
قبط	قِبْطِيّ,قَبَّط
قبق	NEWMORPH
قبل	قَبَّل,قَبْلُ,قِبَل,قَبْلَ,قَبِل-َ
قبلة	قَبَّل,قِبْلَة,قُبْلَة,قِبَل,قَبْلَ,قَبِل-َ
قبلى	قَبَلِيّ,قِبْلِيّ,قِبَل,قَبْلَ,قَبْلِيّ
قبودية	NEWMORPH
قبيس	NEWMORPH
قبيلا	قَبِيل
قبين	قَبَّى,قَبّ
قتات	قَتّات
قتاد	قَتاد
قتائد	NEWMORPH
قتائدات	NEWMORPH
قتائدة	NEWMORPH
قتبان	قَتَب
قتندة	NEWMORPH
قجنجمة	NEWMORPH
قحقح	NEWMORPH
قداح	قِدْح,قَدّاح
قداس	قُدّاس
قدام	قادِم,قُدّامَ,قُدّام
قدة	قَدّ,قُدّ,قِدَّة,قِدّ
قدس	قُدْس,قُدُس,قَدُس,قَدَّس
قدقد	NEWMORPH
قدقداء	NEWMORPH
قدم	قَدِم-َ,قَدَم,قَدُوم,قَدَّم
قدوم	قادِم,قَدُّوم,قُدُوم,قَدُوم
قدومى	قادِم,قَدُّوم,قَدُّومِي,قُدُوم,قَدُوم
قديد	قَدِيد
قديس	قِدِّيس
قذاران	NEWMORPH
قر	قَرّ-َِ,قَرّ
قراب	قِراب,قَرّاب
قرابين	قُرْبان,قَرّاب
قرات	NEWMORPH
قراح	قَراح
قراحصار	NEWMORPH
قرادد	NEWMORPH
قراديس	NEWMORPH
قرار	قَرار
قراس	NEWMORPH
قراص	قُرّاص
قراضة	قَرّاضَة,قُراضَة
قراضم	NEWMORPH
قراضية	NEWMORPH
قراف	NEWMORPH
قراقر	قَرْقَرَة
قراقرة	قَرْقَرَة
قراقري	قَرْقَرَة
قران	قِران
قراوى	NEWMORPH
قرب	قِراب,قُرْب,قِرْبَة,قَرَّب,قَرِب-َ,قَرُب,قُرْبَ
قرباقة	NEWMORPH
قربة	قِراب,قُرْب,قِرْبَة,قَرَّب,قُرْبَة,قَرِب-َ,قَرُب,قُرْبَ
قربق	NEWMORPH
قربى	قِراب,قُرْبَى,قُرْب,قِرْبَة,قِرْبِيّ,قُرْبَ
قربيط	NEWMORPH
قرتا	قَرّ-َِ,قَرَت,قَرَى-ِ,قَرَت-ِ,قَرا
قرتان	NEWMORPH
قرتوه	قَرَت-ِ
قرتيا	NEWMORPH
قرج	NEWMORPH
قرح	قَرِح,قَرْح,قَرْحَة,قَرِح-َ,قَرَح-َ,قَرَّح
قرحان	قَرِح
قرحتاء	NEWMORPH
قرحى	قَرِح,قَرْح,قَرْحَة
قرحياء	NEWMORPH
قرد	قِرْد
قردا	قِرْد
قردة	قِرْد
قردد	NEWMORPH
قردوس	NEWMORPH
قردى	قِرْدِيّ,قِرْد
قرزاحل	NEWMORPH
قرس	قَرِس-َ,قَرَّس
قرشفة	NEWMORPH
قرص	قَرَص,قَرَّص,قُرْص,قُرْصَة,قَرْص
قرطاجنة	قَرْطاجَنَّة
قرطبة	قُرْطُبَة
قرطسا	قَرْطَس
قرطمة	قِرْطِم,قَرْطَم
قرظ	قَرَّظ
قرظان	NEWMORPH
قرعد	NEWMORPH
قرقد	NEWMORPH
قرقر	قَرْقَر
قرقرة	قَرْقَرَة,قَرْقَر
قرقرى	NEWMORPH
قرقسان	NEWMORPH
قرقشندة	NEWMORPH
قرقشونة	NEWMORPH
قرقنة	قَرَق
قرقوب	NEWMORPH
قرقونس	NEWMORPH
قرقية	NEWMORPH
قرقيسياء	NEWMORPH
قركان	NEWMORPH
قرلون	NEWMORPH
قرما	قَرْم,قَرَم-ِ,قُرْمَة
قرماسين	NEWMORPH
قرمان	قَرْم
قرمد	قَرْمَد
قرمس	NEWMORPH
قرملاء	NEWMORPH
قرمونية	NEWMORPH
قرميسين	NEWMORPH
قرن	قِرْن,قَرْن,قَرَن-ِ,قُرْنَة
قرنطاؤوس	NEWMORPH
قرنفيل	NEWMORPH
قرنين	قَرْن
قرورى	NEWMORPH
قروقد	NEWMORPH
قرى	قَرْيَة,قِرَى,قَرّ,قَرَى-ِ
قرياض	NEWMORPH
قريان	NEWMORPH
قرير	قَرِير
قريس	NEWMORPH
قريش	قُرَيْش
قزح	قُزَح,قَزَّح
قزدار	NEWMORPH
قزغند	NEWMORPH
قزقز	قَزْقَز
قزمان	قَزِم,قَزَم
قزوين	قَزْوِين
قزوينك	قَزْوِين
قسا	قَسا,قَسّ
قساء	قِسِّيس
قساس	قَسّاس
قسام	قَسّام,قَسام
قسامل	NEWMORPH
قسر	قَسْر,قَسَر-ِ
قسطانة	NEWMORPH
قسطرة	قَسْطَرَة,قَسْطَر
قسطل	قَسْطَل
قسطلة	قَسْطَل
قسطنطينية	قُسْطَنْطِينِيّ,قُسْطَنْطِينِيَّة
قسطون	قِسْط
قسطيلية	قَسْطِيلِيّ
قسمل	NEWMORPH
قسنطانة	NEWMORPH
قسنطينية	قُسَنْطِنِيّ
قسي	قَسَّى,قَسِيّ,قَسّ
قسياء	NEWMORPH
قسياثا	NEWMORPH
قسيان	قَسِيّ
قسين	قَسَّى,قَسّ
قشاب	NEWMORPH
قشار	NEWMORPH
قشارة	NEWMORPH
قشاقش	NEWMORPH
قشام	NEWMORPH
قشان	NEWMORPH
قشاوة	NEWMORPH
قشب	قَشِيب,قَشَب
قشبرة	NEWMORPH
قشتالة	قَشْتالَة
قشتليون	NEWMORPH
قشمير	NEWMORPH
قصاص	قُصاص,قاصّ,قَصّاص,قِصاص
قصاصة	قُصاص,قُصاصَة,قاصّ,قَصّاص,قِصاص
قصائرة	NEWMORPH
قصة	قَصّ,قِصَّة,قَصَّة
قصدار	NEWMORPH
قصران	قَصْر
قصم	قَصَم-ِ,قَصِم
قصوان	NEWMORPH
قصيص	NEWMORPH
قصيمة	قَصِيم
قضاقضة	NEWMORPH
قضة	قَضّ
قضين	قَضَى-ِ,قَضَّى
قط	قِطّ,قَطّ
قطا	قِطّ,قَطاً,قَطّ
قطاب	NEWMORPH
قطابة	NEWMORPH
قطاتان	قَطاً
قطار	قَطْر,قِطار
قطاقط	NEWMORPH
قطالية	NEWMORPH
قطان	قاطِن,قِطّ,قَطّان,قَطّ
قطانة	قاطِن,قَطّان
قطانقان	NEWMORPH
قطر	قَطَر,قُطْر,قَطْر,قِطار,قَطَّر
قطربل	NEWMORPH
قطرسانية	NEWMORPH
قطرغاش	NEWMORPH
قطرونية	NEWMORPH
قطفتا	قَطَّف,قَطَف-ِ
قطن	قُطْن,قَطَّن,قَطَن
قطنا	قُطْن,قِطّ,قَطَّن,قَطّ,قَطَن
قطوان	NEWMORPH
قطوطى	NEWMORPH
قطيات	NEWMORPH
قطية	قِطّ,قَطّ
قطيعة	قَطِيعَة,قَطِيع
قطين	قِطّ,قَطّ
قعاس	NEWMORPH
قعرة	قَعْرَة,قَعْر,قَعَّر
قعسان	NEWMORPH
قعسرى	NEWMORPH
قعمعم	NEWMORPH
قعيقعان	NEWMORPH
قفصة	قَفَص
قفط	NEWMORPH
قفل	قَفَل,قُفْل,قَفَل-ِ,قَفَّل
قفوص	NEWMORPH
قفير	قَفِير
قفيل	NEWMORPH
قلاب	قَلّاب
قلات	NEWMORPH
قلاخ	NEWMORPH
قلاط	NEWMORPH
قلب	قَلَب-ِ,قَلْب,قَلَّب
قلبين	قَلْب
قلتة	قَلا,قال,قُلَّة,قِلَّة,قَلَى-ِ,قَلَّة
قلحاح	NEWMORPH
قلري	NEWMORPH
قلز	NEWMORPH
قلس	قَلَّس,قَلْس,قَلَس-ِ
قلسانة	NEWMORPH
قلشانة	NEWMORPH
قلع	قِلْع,قَلَع-َ,قَلَّع
قلعة	قَلْعَة,قِلْع,قَلَع-َ,قَلَّع
قلعيت	NEWMORPH
قلفاو	NEWMORPH
قلمرية	NEWMORPH
قلمية	قَلَم,قَلَمِيّ
قلنة	قال
قلندوش	NEWMORPH
قلنسوة	قَلَنْسُوَة
قلهات	NEWMORPH
قلهاث	NEWMORPH
قلهرة	NEWMORPH
قلهى	NEWMORPH
قلهي	NEWMORPH
قلوذية	NEWMORPH
قلورية	NEWMORPH
قلوس	قَلْس
قلوسنا	قَلْس
قلونية	NEWMORPH
قليوش	NEWMORPH
قم	قَمّ
قمادى	NEWMORPH
قمار	قِمار
قمامة	قُمامَة
قمر	قَمَر-ِ,قَمَر,قَمِر-َ,قَمَّر
قمراطة	NEWMORPH
قمراو	NEWMORPH
قملان	قَمِل
قملى	قَمِل,قَمْل,قَمَل
قمن	قام,قَمِن
قمولة	NEWMORPH
قميز	NEWMORPH
قميع	NEWMORPH
قن	قِنّ,قُنّ
قنا	قَنا,قُنّ,قِنّ
قناء	NEWMORPH
قناة	قَناة,قَنَى-ِ,قَنا
قناد	NEWMORPH
قنادر	NEWMORPH
قنارز	NEWMORPH
قناطر	قَنْطَرَة,قَناطِر
قنبان	NEWMORPH
قنبة	قُنَّب,قِنَّب,قَنْب
قنبع	NEWMORPH
قنة	قُنَّة,قُنّ,قِنّ
قنتيش	NEWMORPH
قندابيل	NEWMORPH
قندستن	NEWMORPH
قندهار	قَنْدَهار
قنسرين	NEWMORPH
قنصل	قُنْصُل
قنع	قَنِع,قَنَّع,قَنَع,قَنِع-َ,قِناع,قِنْع
قنوان	قُنْو
قنوة	قَنَى-ِ,قُنْو,قُنْوَة,قَنا
قنوج	NEWMORPH
قنور	NEWMORPH
قنونى	قُنَّة,قَنَى-ِ,قَنا
قنوى	قُنْو
قني	قَنَى-ِ,قِنّ,قُنّ
قنيع	NEWMORPH
قنيلش	NEWMORPH
قنينات	قِنِّينَة
قها	قَها
قهاب	NEWMORPH
قهاد	NEWMORPH
قهج	NEWMORPH
قهجاورسان	NEWMORPH
قهد	NEWMORPH
قهقور	NEWMORPH
قهقوه	NEWMORPH
قهندز	NEWMORPH
قهوان	NEWMORPH
قو	NEWMORPH
قواديان	NEWMORPH
قوارير	قارُورَة
قوان	NEWMORPH
قوبنجان	NEWMORPH
قودم	NEWMORPH
قور	قَوَّر,قارَة
قورا	قَوَّر,قارَة
قوران	NEWMORPH
قورة	قَوَّر,قارَة
قورس	NEWMORPH
قورى	قارَة
قورية	NEWMORPH
قورين	NEWMORPH
قوس	قَوِس-َ,قَوَّس,قَوْس
قوسان	قَوْس
قوسنيا	NEWMORPH
قوسى	قَوْس
قوص	NEWMORPH
قوصرة	NEWMORPH
قوصقم	NEWMORPH
قوط	قُوط,قَوْط
قوفا	NEWMORPH
قوفيل	NEWMORPH
قولو	NEWMORPH
قومس	قَوْمَس
قومسان	NEWMORPH
قومسة	قَوْمَس
قون	قُونَة
قونجة	NEWMORPH
قونكة	NEWMORPH
قونية	قُونِيَة
قوهذ	NEWMORPH
قوهستان	NEWMORPH
قوهيار	NEWMORPH
قوي	قَوِيّ,قَوَّى,قَوِي-َ,قُوَّة,قَوَى
قويق	قُوَيْق
قوين	قَوَّى,قَوِي-َ
قيا	قِياء
قياض	قِياض
قيال	NEWMORPH
قيذوق	NEWMORPH
قيربون	NEWMORPH
قيس	قَيَّس,قَيْس
قيسارية	NEWMORPH
قيسرون	NEWMORPH
قيسون	NEWMORPH
قيشاطة	NEWMORPH
قيطون	NEWMORPH
قيظ	قَيْظ
قيظان	NEWMORPH
قيقان	قاق
قيلة	قَيَّل,قَيْل
قيلوية	NEWMORPH
قيمر	NEWMORPH
قيمون	NEWMORPH
قين	قَيْن
قينان	قِينان
قينقاع	NEWMORPH
قينية	NEWMORPH
قيوان	NEWMORPH
كابة	آب,آبِه,أَبَه
كابل	كابُل,إِبْل,كابِل,كابَل
كابلستان	NEWMORPH
كاث	NEWMORPH
كاج	NEWMORPH
كاجر	أُجْرَة,أَجْر
كاجغر	NEWMORPH
كاخ	أَخ
كاخشتوان	NEWMORPH
كاذة	NEWMORPH
كار	كار,آر
كارة	كار,كارِه,آر
كارز	كارِز,رُزّ,أَرْز
كارزن	NEWMORPH
كارزين	كارِز
كاريان	NEWMORPH
كازر	أَزْر,إِزار
كازرون	NEWMORPH
كازه	أَزّ
كازياركاه	NEWMORPH
كاسان	NEWMORPH
كاسكان	إِسْكان
كاسن	آسِن,أَسَنّ
كاشان	NEWMORPH
كاشغر	NEWMORPH
كاشكن	NEWMORPH
كاظمة	كاظِم,كاظِمَة
كافر	كافِر
كافل	آفِل,كافَل,كافِل
كاكدم	NEWMORPH
كاكس	إِكْس
كالخسان	NEWMORPH
كالف	آلِف,أَلَفّ,آلَف,إِلْف,أَلِف,أَلْف
كالوان	لَوْن,أَلْوان
كالينكوس	NEWMORPH
كامخية	NEWMORPH
كامدذ	NEWMORPH
كامس	أَمْس,أَمَسّ
كانم	NEWMORPH
كاهون	أَهْوَن
كاوار	أُوار
كاوخواره	NEWMORPH
كاودان	NEWMORPH
كاوردان	NEWMORPH
كاوزن	NEWMORPH
كبا	كَبا,كَبّ
كباب	باب,كَباب
كباث	NEWMORPH
كبد	كَبِد,كَبَّد,بُدّ,كَبَد
كبر	بُرّ,بَرّ,بِرّ,كِبْر,كِبَر,كُبْر,كَبَّر,كَبَر
كبشات	NEWMORPH
كبشة	كُبْشَة,كَبْشَة,كَبَش,كَبْش
كبكب	كَبْكَب
كبندة	بَنْدا,بَنْد
كبوذ	NEWMORPH
كبوذان	NEWMORPH
كبوذنجكث	NEWMORPH
كبيب	بِيانُو
كبيرة	بِيرَة,بِيرا,كَبِير,كَبِيرَة
كبيس	كَبِيس
كبيسة	بَيْسَة,كَبِيس
كبيش	NEWMORPH
كبين	بِين,بَيْنَ,بَيِّن
كتانان	NEWMORPH
كتانة	كَتّان
كتد	NEWMORPH
كتلة	كَتَّل,تَلَّة,كَتْل,كَتَل,تَلّ,كُتْلَة
كتم	كَتْم,كَتَّم,كَتَم
كتمان	كِتْمان
كتمة	كَتْم,كَتَّم,كَتَم
كتمى	كَتْم
كتيب	كُتَيِّب
كتيبة	كُتَيِّب,كَتِيبَة
كتيفة	NEWMORPH
كث	كَثّ-ِ,كَثّ
كثاب	NEWMORPH
كثابة	NEWMORPH
كثب	كَثَب,كَثِيب
كثبة	كَثَب,كَثِيب
كثه	كَثّ
كثوة	ثُوَّة
كج	NEWMORPH
كجه	NEWMORPH
كحكب	NEWMORPH
كحل	حِلّ,كَحِل,كَحَّل,كُحْل,حَلّ
كحلان	كَحِل
كحلة	حِلَّة,كُحْلَة,حِلّ,كَحِل,كَحَّل,كُحْل,حُلَّة,حَلَّة,حَلّ
كحيلة	حِيلَة,حَيْل,كَحِيل
كداء	داء
كدادة	دادَة
كدال	دالّ,دال
كدد	كَدَّد
كدر	كَدَر,كَدُر,كَدَّر,دَرّ,دُرّ,كَدِر,كَدِر-َ
كدراء	أَكْدَر,دُرّاء
كدك	دَكّ,كَدّ
كدم	دَم,دَمّ,كَدْم,كَدَم
كدن	كاد-َ,كاد-ِ
كدى	كَدَى-ِ,كَدّ,كَدَّى,كَدْي
كدي	كَدَى-ِ,كَدّ,كَدَّى,كَدْي
كذج	NEWMORPH
كر	كَرّ
كراء	كِراء,راء,رائِي
كراثا	كَرّاث
كراجك	كَراج
كراش	NEWMORPH
كراع	كُراع,راع,راعِي
كراغ	NEWMORPH
كران	NEWMORPH
كرانطه	NEWMORPH
كربلاء	كَرْبَلاء
كرتم	رَتَم-َ
كرث	كَرَث,رَثّ
كرج	رَجّ,كُرْج
كرجة	رَجّ,كُرْج,رَجَّة
كرجن	NEWMORPH
كرخايا	NEWMORPH
كرخيني	NEWMORPH
كرد	كُرْدِيّ,رَدّ
كرداح	NEWMORPH
كردر	NEWMORPH
كردشير	NEWMORPH
كرديز	NEWMORPH
كرزبان	NEWMORPH
كرزين	كَرْز,رَزِين
كرسفة	رَسْف,كَرْسَفَة,كَرْسَف
كرسكان	NEWMORPH
كرسي	كُرْسِيّ
كرعة	كَرَع-َ,كَرْع
كرفة	رِفْه,رَفّ
كرك	كُرْك,كَرّ
كركان	NEWMORPH
كركانج	NEWMORPH
كركر	كَرْكَر
كركسكوه	NEWMORPH
كركنت	NEWMORPH
كركور	كَرْكُور
كركويه	NEWMORPH
كركى	كُرْكِيّ,كُرْك
كركين	رَكِين
كرم	كَرَم,كَرَّم,كَرْم,رَمّ,كَرُم
كرماطة	NEWMORPH
كرمان	رُمّان
كرمة	كَرَم,كَرَّم,كَرْم,كُرْمَة,رَمّ,رِمَّة,رُمَّة
كرمجين	NEWMORPH
كرمل	رَمْل,كَرْمَل
كرمليس	NEWMORPH
كرملين	كرِمْلِين
كرمى	كَرَم,رَمْي,كَرْم,كَرَمِيّ,كَرْمِيّ,رَمّ
كرمية	رَمْي,رَمْيَة,رَمِيَّة
كرمينية	NEWMORPH
كرنبا	NEWMORPH
كرنبة	كُرُنْب
كرنة	رَنَّة
كرنك	كَرْنَك,كرَنْك
كره	كَرِه-َ,كَرْه,كَرُه,كَرَّه,كَرِه,كَرّ,كُرَة,كُرْه
كروان	كَرَوان,رُوان
كروخ	NEWMORPH
كريب	رَيْب,رِيبَة
كريت	كِرِيت,كَرِي-َ,كَرَى-ِ
كرين	كَرِي-َ,كَرَى-ِ
كريون	NEWMORPH
كزد	NEWMORPH
كزك	كَزّ,كُزّ
كزمان	زَمان
كزنا	كَزّ,زِنَى,كُزّ
كزنة	زِنَة,زَنّ
كزه	كَزّ,كُزّ
كزيريم	NEWMORPH
كس	NEWMORPH
كساب	NEWMORPH
كسادن	سادِن
كسبة	سَبّ,كُسْبَة,سُبَّة,كَسْب,كَسَب-ِ,سَبَّة,كَسَّب,سَبَه
كستانة	ساتان
كسف	كَسْف,كَسَف-ِ
كسفة	سَفَه,كَسْف,كَسَف-ِ
كسكر	سُكْر,سُكَّر
كسير	سِيرَة,سَيْر,كَسِير
كش	كَشّ-ِ
كشاف	شافِي,كَشّاف
كشانية	NEWMORPH
كشب	شَبّ
كشبى	شَبّ,شَباً
كشت	كَشّ-ِ,شَتّ
كشح	كَشَح-َ,كُشْح,كَشْح,شُحّ
كشر	كَشَّر,شَرّ,كَشَر-ِ
كشفة	شِفّ,كَشَف-ِ,كَشْف,كاشِف,شَفَة
كشفريد	NEWMORPH
كشفل	NEWMORPH
كشكينان	NEWMORPH
كشمر	شَمَر
كشميهن	شَمِّيّ
كشور	NEWMORPH
كفافة	كِفاف,كَفاف,كِفَّة,كِفافَة
كفة	كَفّ,كُفَّة,كِفَّة
كفت	كَفَت-ِ,كِفْت,كَفّ,كَفَى-ِ,كَفَّت
كفجين	فَجّ
كفرباويط	NEWMORPH
كفربطنا	NEWMORPH
كفربيا	NEWMORPH
كفرتبيل	NEWMORPH
كفرتكيس	NEWMORPH
كفرتوثا	NEWMORPH
كفرجديا	NEWMORPH
كفرحجر	NEWMORPH
كفردبين	NEWMORPH
كفرروما	NEWMORPH
كفرزمار	NEWMORPH
كفرزنس	NEWMORPH
كفرسابا	NEWMORPH
كفرسبت	NEWMORPH
كفرسلام	NEWMORPH
كفرسوت	NEWMORPH
كفرسوسية	NEWMORPH
كفرطاب	NEWMORPH
كفرعزا	NEWMORPH
كفرعزون	NEWMORPH
كفرغما	NEWMORPH
كفركنا	فَرْك
كفرلاب	NEWMORPH
كفرلاثا	NEWMORPH
كفرلهثا	NEWMORPH
كفرمثرى	NEWMORPH
كفرمندة	NEWMORPH
كفرنبو	NEWMORPH
كفرنجد	NEWMORPH
كفرنغد	NEWMORPH
كفرية	كَفَر,فِرْيَة,فَرِيّ
كفشيشيوان	NEWMORPH
كفين	فِين,كَفّ,كَفَى-ِ
كقولك	قَوْل
كلاباذ	NEWMORPH
كلار	NEWMORPH
كلارجه	NEWMORPH
كلاشكرد	NEWMORPH
كلاع	NEWMORPH
كلاف	كَلّاف
كلالى	كَلال
كلام	لام,كَلام
كلامين	لام
كلان	NEWMORPH
كلاه	لاهِي,كُلْوَة
كلاوتان	NEWMORPH
كلب	كَلَب,كَلِب,كَلْب,كَلِب-َ,لُبّ,كَلَّب
كلبة	كَلَب,كَلِب,لِبَّة,لَبَّة,كَلْب,لُبّ,كَلَّب,كَلْبَة
كلخباقان	NEWMORPH
كلختجان	NEWMORPH
كلز	لَزّ
كلفى	كَلِف,أَكْلَف,كُلْفَة,لِفّ,لَفّ,كَلَف
كلك	كَلَك,كُلّ,لُكّ,لَكّ
كلكبود	NEWMORPH
كلكس	NEWMORPH
كلكوى	NEWMORPH
كلمان	NEWMORPH
كلندى	NEWMORPH
كله	كُلّ,كُلَّة,أَكَل,كِلَّة
كلواذ	NEWMORPH
كلواذة	NEWMORPH
كلواذى	NEWMORPH
كلوة	كُلْوَة,أَكَل
كلية	كُلْوَة,لَيّ,كُلِّيَّة,أَكَل,كُلِّيّ,لَيَّة
كليجرد	NEWMORPH
كليل	كَلِيل,لَيْل
كلين	لِين,لَيِّن
كليوان	لِيوان
كمارى	مارِي,مارّ
كمام	كِمام
كمخ	مُخّ,كَمَخ-َ
كمران	مِران
كمرة	مَرّ,كَمَرَة,مُرّ,مَرَّة,كَمَر
كمرجة	مَرْج,مَرَج
كمرد	مَرَدّ,أَمْرَد
كمزار	مَزار
كمسان	مِسَنّ
كمع	NEWMORPH
كملى	مُلَّى,مَلَى,مِلِّيّ,مَلّ,مَلِيّ
كمم	كَمَّم
كمنجث	NEWMORPH
كمندان	NEWMORPH
كمندة	NEWMORPH
كمينان	كَمِين
كن	كِين,كَنّ-ِ,كان,كَنّ
كنابيل	NEWMORPH
كنابين	ناب,نابِي
كناثر	ناثِر
كنارك	نار,كَنار
كناس	ناس,ناسِي,كَنّاس
كناوه	NEWMORPH
كنب	كَنَب,كَنِب
كنبانية	NEWMORPH
كنبوت	نَبُّوت
كنة	كُنْه,كَنّ-ِ,كان,كَنّ,كُنَّة,كَنَّة
كنتدة	NEWMORPH
كنثيل	NEWMORPH
كنجة	NEWMORPH
كنجرستاق	NEWMORPH
كنجروذ	NEWMORPH
كنجكان	NEWMORPH
كند	نَدّ,نِدّ
كنداكين	NEWMORPH
كندانج	NEWMORPH
كندة	نَدّ,نَدْه,نِدّ
كندر	نَدْر,كُنْدُر
كندران	NEWMORPH
كندسروان	NEWMORPH
كندكين	NEWMORPH
كندلان	NEWMORPH
كندوان	نَدْوان
كندير	NEWMORPH
كنر	NEWMORPH
كنزة	نَزَّة,كِنْزَة,نَزّ,نَزَه,كَنَز-ِ,نَزِه,نُزَه,كَنْز,كَنِز
كنسروان	NEWMORPH
كنطي	نَطّ
كنعان	كَنْعان
كنفى	نَفِيّ,نَفْي,كَنِيف,كَنَف
كنك	نِك,كَنّ-ِ,كان,كَنّ
كنكار	NEWMORPH
كنكور	NEWMORPH
كنن	كَنّ-ِ
كنهل	نَهْل
كنون	كَنا,نُون
كنيكر	NEWMORPH
كهاتان	NEWMORPH
كهال	هال,كَهْل,هَيْل
كهك	NEWMORPH
كهلان	كَهْل
كهيلة	هَيْل
كوار	NEWMORPH
كواكب	كَوْكَب
كوال	والِي,كُوال
كوبان	كوان
كوبانان	NEWMORPH
كوبنجان	NEWMORPH
كوبيان	كُوبِيّ
كوتم	NEWMORPH
كوث	NEWMORPH
كوثابه	وَثّاب
كوثر	وَثِر,كَوْثَر
كوثى	NEWMORPH
كود	وُدّ,كَوَّد
كوذب	NEWMORPH
كور	كُورَة,كَوَّر,كُور
كوران	NEWMORPH
كورداباذ	NEWMORPH
كوزا	كُوز
كوزكنان	NEWMORPH
كوساء	NEWMORPH
كوسين	NEWMORPH
كوشان	NEWMORPH
كوعة	كُوع
كوفا	NEWMORPH
كوفان	NEWMORPH
كوفد	وَفْد
كوفن	NEWMORPH
كوفياباذقان	NEWMORPH
كوك	كَوَّك,كُوك
كوكب	وَكْب,كَوْكَب
كوكبان	وَكَبان,كَوْكَب
كوكبى	وَكْب,كَوْكَبِيّ,كَوْكَب
كوكو	NEWMORPH
كول	كُول
كولان	كُولان
كوم	كَوْم,كَوْمَة,كَوَّم,كُوم
كومح	NEWMORPH
كومخان	NEWMORPH
كومل	NEWMORPH
كوملاذ	NEWMORPH
كوميد	NEWMORPH
كومين	كَوْم
كونجان	NEWMORPH
كوهك	NEWMORPH
كوهيار	NEWMORPH
كوير	NEWMORPH
كويلح	NEWMORPH
كيخاران	NEWMORPH
كيدمة	NEWMORPH
كير	كِير
كيران	كِير
كيرداباذ	NEWMORPH
كيركابان	NEWMORPH
كيز	NEWMORPH
كيسب	NEWMORPH
كيسوم	NEWMORPH
كيش	NEWMORPH
كيف	كَيْف,كَيْفَ
كيفا	كَيْف
كيفانة	NEWMORPH
كيل	كَيَّل,كَيْل
كيلاهجان	NEWMORPH
كيلكى	NEWMORPH
كيلين	NEWMORPH
كيمارج	NEWMORPH
كيماك	NEWMORPH
لابة	آب,لاب,آبِه,أَبَه,أَبّ,أَبَه-َِ
لاحج	حَجّ
لاذر	ذَرّ,وَذِر-َ
لاذكرد	NEWMORPH
لارجان	أَرِج
لاردة	أَرَدّ,رَدّ,وَرَد-ِ
لارز	أَرَزّ,رَزّ,رُزّ,أَرْز
لاز	أَزّ
لاشكرد	NEWMORPH
لاعة	NEWMORPH
لافت	فَتّ,لاف,لافِت
لاكمالان	NEWMORPH
لامجان	NEWMORPH
لامس	أَمَسّ,أَمْس,لامَس,وَمَس-ِ,مَسّ-َ
لامش	مَشّ
لامغان	NEWMORPH
لانجش	جاش-ِ,جَشّ
لاهج	هَجّ,وَهَج-ِ
لاهون	لاهِي,هَوَّن,أَهْوَن,هان
لاوجه	وَجَّه,أَوْج
لاوي	لاوِي,أَوَى-ِ,أَوَّى,آوَى
لاى	أَيّ
لاي	أَيّ
لب	لَبّ-َُ,لُبّ,لَبّ
لبا	لَبّ-َُ,لُبّ,لَبّ
لباب	باب
لبابة	بابِه,باب
لباح	باح
لبب	لَبَب,لَبَّب
لبدة	لَبَّد,لِبْدَة,لِبْد,لُبَد,بُدّ,لَبِد,لَبَد,لُبْدَة,بَدَه-َ,بَدّ
لبشمون	NEWMORPH
لبطيط	NEWMORPH
لبلة	أَبْلَه,بَلّ,بَلّ-ِ,بَلَه,بَلِه-َ,بِلّ,بِلَّة
لبن	بُنّ,لِبْن,لَبِنَة,لاب,بِن,لَبَن,لَبَّن,بان-ِ
لبنان	بَنان,لُبْنان
لبنة	بُنّ,لِبْنَة,لِبْن,لَبِنَة,لاب,لَبَن
لبنى	بُنّ,لَبَنِيّ,لُبْنَى,لِبْن,لَبِنَة,بِنْيَة,بَنَى-ِ,بَنِي,بِن,لَبَن,بُنَيّ,لَبّ
لبوان	NEWMORPH
لبون	لَبُون,لَبِنَة,بَون
لبيرى	بِيرِي,لِيبِيرِيّ
لبينة	بَيِّنَة,بَيَّن,بَيْنَ,لَبَّى,بَيِّن
لتنكشة	نَكَش-َِ
لثجة	NEWMORPH
لثلث	ثُلْث,ثَلَّث
لجا	لُجّ,لَجّ-َِ
لجاة	جاه
لجان	جانِي,لَجْنَة,جان
لجم	لَجَّم,جَمّ,لَجَم,جَمّ-ُِ,لِجام,لَجْم
لجنياته	جَنْي
لحاء	لِحاء,حاء
لحج	لَحَج,حَجّ
لحظة	لَحْظَة,حَظّ,لَحَظ-َ,لَحْظ
لحف	لِحْف,حَفّ,لِحاف,حَفّ-ِ,لَحَف-َ
لحوظ	NEWMORPH
لحيان	حَيّ,لَحْي
لحيظ	NEWMORPH
لد	أَلَدّ,لِدّ,لَدّ
لرت	رُتّ
لرقة	رَقّ,رِقّ,رِقَّة
لسعى	لَسْع,سَعَى-َ,لَسِيع,سَعْي
لسلسى	سَلِس,سَلَس
لسنونة	سَنا
لسيس	NEWMORPH
لشبونة	لِشْبُونَة
لصاف	صافِي
لصبين	صَبِي-َ,صَبَّى
لصف	صَفّ
لصوب	صَوْب,صَوَّب
لطمين	طَمَى-ِ
لظى	لَظِي-َ,لَظَى
لعبا	عَبا,لَعِب-َ,عَبّ,لَعْب
لعباء	عَباء
لعس	عَسّ
لعلع	لَعْلَع
لغابر	غابِر
لغاط	NEWMORPH
لغوى	غَوَى-ِ,لَغْو,غَوِي-َ,لُغَوِيّ,غَوَّى
لفات	فات,لَفَّة,لَفات
لفت	أَلْفَت,فَتّ,لَفَت-ِ,لاف,لِفْت,فات,لَفْت,لَفّ,لَفَّت
لفتوان	NEWMORPH
لفلف	لَفْلَف
لفوان	NEWMORPH
لقاع	قاع
لقان	قانِئ,قانِي
لقرشان	قِرْش
لقط	قِطّ,لُقْطَة,لَقَط,قَطّ,لَقَّط
لقف	قَفّ,لَقْف,لَقِف-َ
لقنت	لَقِن-َ,لَقَّن,قَنَى-ِ,قَنا,قَنَت
لك	لِ-,لُكّ,لَكّ
لكان	كان,لَكّ
لكز	لَكَز,لَكِز,كَزّ,كُزّ,لَكْز
لماية	NEWMORPH
لمطة	مَطّ
لمغان	مَغْنَى
لنبان	أَبان
لنجوية	NEWMORPH
لهاب	هاب-َ,لُهاب,لَهْبان
لهاور	NEWMORPH
لهيا	لَهِي-َ,لُهِيّ,لَهَّى
لهيم	هَيَّم,هائِم
لواتة	لاوِي,وات
لوان	NEWMORPH
لوبة	وَبَه-َ,وَبْه
لوبيا	لُوبِياء
لوبياباذ	NEWMORPH
لوبية	NEWMORPH
لوخ	NEWMORPH
لوذ	NEWMORPH
لوذان	NEWMORPH
لوردجان	NEWMORPH
لورقة	وَرَق,وَرَّق
لوشة	NEWMORPH
لوكر	وَكْرَة,وَكْر,وَكَّر
لولخان	NEWMORPH
لؤلؤة	لُؤْلُؤ
لوهور	NEWMORPH
لوية	NEWMORPH
ليانجل	NEWMORPH
لية	وَهَى-ِ,لَيّ,لَيَّة
ليع	وَعَى-ِ
ليلش	NEWMORPH
ليلون	لَوَّن
ليلى	لَيْلَى,وَلِي-ِ,لَيْل,لَيْلِيّ
ليموسك	NEWMORPH
لين	وَنَى-ِ,يِن,لَيَّن,لِين,لَيِّن
لينة	نَها,وَنَى-ِ,يِن,لَيَّن,لِين,لَيِّن,نَهَى-ِ,أَنْهَى
ماب	NEWMORPH
مابد	NEWMORPH
مابرسام	NEWMORPH
ماتيرب	NEWMORPH
ماجان	NEWMORPH
ماجج	NEWMORPH
ماجد	ماجِد
ماجرم	NEWMORPH
ماجن	ماجَن,ماجِن
ماجندان	NEWMORPH
ماخ	NEWMORPH
ماخان	NEWMORPH
ماخوان	NEWMORPH
ماذانكت	NEWMORPH
ماذران	NEWMORPH
ماذرايا	NEWMORPH
ماذروستان	NEWMORPH
مارب	NEWMORPH
ماربانان	NEWMORPH
مارث	NEWMORPH
مارد	مارِد
ماردة	مارِد
ماردين	مارِد
مارشك	NEWMORPH
مارمل	NEWMORPH
ماروان	NEWMORPH
مارية	مارّ
مازج	مازَج
مازر	NEWMORPH
مازل	NEWMORPH
مازن	مازِن
مازندران	NEWMORPH
ماسبذان	NEWMORPH
ماستي	ماس,ماسّ
ماسح	ماسَح,ماسِح
ماسخ	NEWMORPH
ماسط	NEWMORPH
ماسكان	NEWMORPH
ماسكنات	NEWMORPH
ماسل	NEWMORPH
ماسوراباذ	NEWMORPH
ماشان	NEWMORPH
ماشتكين	NEWMORPH
ماشية	ماشِيَة,ماشِي
ماعزة	ماعِز,ماعِزَة
ماغرة	NEWMORPH
ماقلاصان	NEWMORPH
ماكسين	NEWMORPH
مالان	NEWMORPH
مالبان	NEWMORPH
مالطة	مالْطا
مالقة	مالَقَة,مالَق
مالين	NEWMORPH
مامطير	NEWMORPH
ماند	وَدَى-ِ
ماندكان	NEWMORPH
مانق	وَقَى-ِ
مانقان	NEWMORPH
ماهان	NEWMORPH
ماهياباذ	NEWMORPH
ماهيان	مائِيّ
ماوان	NEWMORPH
ماوانة	NEWMORPH
ماوشان	NEWMORPH
ماوية	مائِيّ,مائِيَّة
ماوين	NEWMORPH
مائد	مائِد
مايدشت	NEWMORPH
مائر	NEWMORPH
مائق	NEWMORPH
مايمرغ	مَرَّغ,أَمْرَغ
مائين	NEWMORPH
مبايض	NEWMORPH
مبرة	مَبَرَّة
مبرك	NEWMORPH
مبركان	NEWMORPH
مبعوق	NEWMORPH
مبلت	NEWMORPH
مبهل	NEWMORPH
مبين	مُبِين,مُبَيِّن
متالع	NEWMORPH
متريس	NEWMORPH
متلجتم	NEWMORPH
متن	مَتْن,مَتَن,مَتَّن,مات
متوث	NEWMORPH
متيجة	NEWMORPH
مثر	NEWMORPH
مثعر	NEWMORPH
مثعلب	NEWMORPH
مثقب	NEWMORPH
مثوب	NEWMORPH
مثوة	NEWMORPH
مجاح	NEWMORPH
مجالخ	NEWMORPH
مجانة	مِجَنّ,مَجّان,ماجِن,مَجانَة
مجبست	NEWMORPH
مجداباذ	NEWMORPH
مجدل	مَجْدَل
مجدليابة	NEWMORPH
مجدوان	NEWMORPH
مجدول	مَجْدُول
مجدون	مُجْدِي,مُجِدّ
مجذونية	NEWMORPH
مجر	مَجَرّ,مَجَر
مجريط	مَجْرِيط
مجسد	مُجَسَّد
مجنب	NEWMORPH
مجنة	مِجَنّ,ماج,مَجَن
مجنح	مُجَنَّح
مجنقون	NEWMORPH
مجيرة	مُجِير
محا	مَحا,مُحّ,مَحّ
محبل	NEWMORPH
محبلة	NEWMORPH
محتد	مُحْتَدّ,مَحْتِد
محجر	مَحْجَر,مَحْجِر
محجن	مِحْجَن
محراج	NEWMORPH
محرمة	مَحْرَم,مَحْرَمَة,مُحَرَّم
محريط	NEWMORPH
محسر	NEWMORPH
محصن	مُحَصَّن,مَحَّص,مُحْصَن,مَحَص-َ,مُحْصِن
محضر	مُحَضَّر,مَحْضَر,مُحَضِّر
محضرة	مُحَضَّر,مَحْضَر,مُحَضِّر
محضوراء	NEWMORPH
محلم	NEWMORPH
محمة	مِحَمّ
محمداباذ	NEWMORPH
محمر	مُحَمَّر
محنب	NEWMORPH
محنة	ماح-ِ,مَحَن-َ,مِحْنَة
محواش	NEWMORPH
محورة	مِحْوَر,مُحَوَّر,مَحْوَر
محياه	مَحَّى
محيص	مَحِيص
محيلات	مُحِيل
مخاشن	NEWMORPH
مخايل	مَخِيلَة
مختاران	مُخْتار
مخدرة	مُخَدَّر,مُخَدِّر
مخرفة	مُخَرِّف,مَخْرَفَة
مخرمة	مُخَرَّم
مخرىء	NEWMORPH
مخضوراء	NEWMORPH
مخطط	مُخَطِّط,مُخَطَّط
مخفق	NEWMORPH
مخمد	NEWMORPH
مخمر	مُخَمَّر
مخمسة	مُخَمَّس
مخيض	مَخِيض
مخيط	مِخْيَط,مُخَّيْط
مخيل	مُخِيل
مداخل	مَدْخَل
مدالة	NEWMORPH
مدام	مُدام,مَدام
مدبج	مُدَبَّج
مدر	مُدِرّ,مَدَر
مدران	مُدِرّ
مدرج	مُدْرَج,مَدْرَج,مُدَرَّج
مدرك	مُدِرّ,مُدْرِك,مَدَر
مدرى	مُدِرّ,مَدَر,مِدْرَى
مدع	مُدَّعِي
مدعا	NEWMORPH
مدفار	NEWMORPH
مدلين	مُدِلّ
مديانكث	NEWMORPH
مدين	مُدِين,مَدِين
مذحج	NEWMORPH
مذر	مَذِر-َ,مَذَّر,مَذِر,مَذَر
مذعر	NEWMORPH
مذعى	NEWMORPH
مذفار	NEWMORPH
مذود	مِذْوَد
مذيامجكث	NEWMORPH
مذيانكن	NEWMORPH
مذيح	NEWMORPH
مذينب	NEWMORPH
مر	مَرّ,مُرّ
مرابض	مَرْبِض
مراة	مَرّ,مُرّ
مراخ	NEWMORPH
مراد	مُراد,مارِد,مَراد,مَرّاد
مرازم	NEWMORPH
مراغة	NEWMORPH
مراقية	مِرْقاة
مراكش	مَرّاكِش,مَرّاكُش
مرامر	NEWMORPH
مران	مُرّ,مِران
مرانة	مِران
مراهط	NEWMORPH
مرباط	NEWMORPH
مربالا	NEWMORPH
مربخ	NEWMORPH
مربع	مَرْبَع,مُرَبَّع
مربله	NEWMORPH
مربوط	مَرْبُوط
مربولة	NEWMORPH
مربيطر	NEWMORPH
مرت	مار,مار-ِ,مَرّ
مرتج	مُرْتَجّ
مرتحوان	NEWMORPH
مرج	مَرَج,مَرْج
مرجبى	NEWMORPH
مرجح	مَرْجَح,مُرَجِّح,مُرَجَّح
مرجم	NEWMORPH
مرجيق	NEWMORPH
مرحب	مَرْحَب,مُرَحِّب
مرحض	NEWMORPH
مرحيا	NEWMORPH
مرخ	مَرَخ-َ,مَرْخ,مَرِخ,مَرَّخ
مرخة	مَرَخ-َ,مَرْخ,مَرِخ,مَرَّخ
مردا	مَرَّد,مَرَدّ,مَرَد,أَمْرَد
مرداء	مَرِيد,أَمْرَد
مردان	مَرَدّ
مرز	مَرَزّ
مرزنكى	NEWMORPH
مرزوها	NEWMORPH
مرس	مَرْس,مَرِس,مَرَس
مرست	مَرَس
مرسية	مَرِس,مُرْسِيَة
مرشانة	NEWMORPH
مرصفا	NEWMORPH
مرعش	NEWMORPH
مرغاب	NEWMORPH
مرغبان	NEWMORPH
مرغبون	NEWMORPH
مرغة	مَرَّغ
مرغريطة	NEWMORPH
مرغينان	NEWMORPH
مرفق	مِرْفَق,مُرْفَق
مرق	مَرَق,مَرَّق
مرقية	NEWMORPH
مركلان	NEWMORPH
مركه	NEWMORPH
مركوب	مَرْكُوب
مركوز	NEWMORPH
مركيش	NEWMORPH
مرماجنة	NEWMORPH
مرمل	NEWMORPH
مرمى	مَرْمَى,مَرْمِيّ
مرند	NEWMORPH
مرو	مَرْو,مَرْوَة
مروان	مَرْوان
مروذ	NEWMORPH
مروراة	NEWMORPH
مريجز	NEWMORPH
مريح	مُرِيح,مِرِّيح
مريخ	مِرِّيخ
مريد	مَرِيد,مُرِيد
مريسة	مَرِيسَة
مريع	مَرِيع,مُرِيع
مريفق	NEWMORPH
مريمين	NEWMORPH
مرين	مُرّ
مريوط	NEWMORPH
مزاحم	مُزاحِم
مزج	مَزَج,مَزْج
مزدقان	NEWMORPH
مزرنكن	NEWMORPH
مزرين	مُزْرِي,مُزْرَى
مزن	مُزْن,ماز-ِ
مزنوى	NEWMORPH
مزيد	مَزِيد
مسانة	مِسَنّ
مسبر	مِسْبَر
مستينان	NEWMORPH
مسحلان	مِسْحَل
مسرابا	NEWMORPH
مسرقان	NEWMORPH
مسروح	NEWMORPH
مسطاسة	NEWMORPH
مسطح	مُسَطَّح
مسعط	مِسْعَط
مسفرا	مُسْفِر
مسقط	مَسْقَط
مسكة	مَسْك,مَسَّك,مُسْكَة,مِسْكَة,مِسْك,مَسَك,مَسْكَة
مسكر	مُسَكَّر,مُسْكِر
مسكن	مُسَكِّن,مَسّ,مَسَّك,مَسْكَن,مَسَك,مَسّ-َ
مسكى	مَسْك,مِسْك
مسلح	مُسَلِّح,مُسَلَّح
مسلحة	مُسَلِّح,مُسَلَّح
مسلوق	مَسْلُوق
مسلية	مُسَلِّي
مسنان	مِسَنّ,مُسِنّ
مسور	مُسَوَّر
مسوس	مُسَوِّس
مسولا	NEWMORPH
مسيحة	مُسَيَّح,مَسِيح
مسينان	NEWMORPH
مسيني	NEWMORPH
مشاحج	NEWMORPH
مشار	مُشار
مشان	NEWMORPH
مشتلة	مَشْتَل
مشتول	NEWMORPH
مشحاذ	NEWMORPH
مشحلا	NEWMORPH
مشخرة	NEWMORPH
مشرجة	NEWMORPH
مشرد	مُشَرَّد
مشرف	مُشَرِّف,مُشْرِف,مُشَرَّف,مَشْرَف
مشرق	مُشْرِق,مَشْرِق
مشرقين	مُشْرِق
مشروح	NEWMORPH
مشروق	NEWMORPH
مشريق	NEWMORPH
مشعل	مِشْعَل,مَشْعَل
مشغرى	NEWMORPH
مشقلقيل	NEWMORPH
مشكاذين	NEWMORPH
مشكان	NEWMORPH
مشكويه	NEWMORPH
مصر	مِصْر,مُصِرّ
مصراثا	NEWMORPH
مصقلاباذ	NEWMORPH
مصقلة	مِصْقَلَة
مصلحكان	NEWMORPH
مصلوق	NEWMORPH
مصنعة	مُصَنِّع,مَصْنَع,مُصَنَّع
مصياب	NEWMORPH
مصيرة	مَصِيرَة,مَصِير
مصيل	NEWMORPH
مضنونة	NEWMORPH
مطار	مَطار
مطارب	NEWMORPH
مطارة	مَطار
مطاره	مَطار
مطامير	NEWMORPH
مطر	مَطِر,مَطَر,مُطْرِي
مطرق	مُطْرِق,مِطْرَق
مطعم	مَطْعَم,مُطَعَّم
مطلح	NEWMORPH
مطلوب	مَطْلُوب
مطمورة	مَطْمُورَة,مَطْمُور
مطوعة	مُطَوِّع
مطيرة	مُطَيْر,مَطِير
مطيطة	NEWMORPH
مظة	NEWMORPH
مظعن	NEWMORPH
مظللة	مُظَلِّل
مظلم	مُظْلِم
مظلومة	مَظْلُوم
مظهران	مَظْهَر,مُظَهِّر
معاذ	مَعاذ
معاذة	مَعاذ
معافر	NEWMORPH
معان	مُعانِي,مَعْنَى
معاهر	NEWMORPH
معبر	مُعَبَّر,مَعْبَر,مُعَبِّر
معتق	مُعَتَّق,مُعْتِق
معراثا	NEWMORPH
معرش	NEWMORPH
معروف	مَعْرُوف
معصوب	مَعْصُوب
معظم	مُعَظَّم,مُعْظَم
معقر	NEWMORPH
معقلة	مَعْقِل
معلا	مُعَلّ,مُعَلّا
معلشايا	NEWMORPH
معلق	مُعَلَّق,مُعَلِّق
معلولا	مَعْلُول
معليا	مُعَلَّى
معمر	مُعَمَّر
معمراش	NEWMORPH
معمران	مُعَمَّر
معنق	NEWMORPH
معوز	مُعْوِز
معولة	مِعْوَل,مُعَوَّل,مُعَوِّل
معونة	مَعُونَة,مَعا
معيط	NEWMORPH
معين	مُعَيَّن,مَعِين,مُعِين
مغار	مَغار
مغارب	مَغْرِب
مغام	NEWMORPH
مغرة	مُغْرَة,مَغَر
مغز	NEWMORPH
مغكان	NEWMORPH
مغنان	مُغِنّ
مغون	NEWMORPH
مغونة	NEWMORPH
مغيلة	NEWMORPH
مفتح	مُفَتِّح
مفحل	NEWMORPH
مقاريب	مِقْراب
مقاس	مَقاس
مقامي	مَقام,مِقَمَّة,مُقام
مقتد	NEWMORPH
مقد	مِقَدّ
مقدشو	NEWMORPH
مقذ	NEWMORPH
مقذونية	NEWMORPH
مقر	مَقَرّ
مقراة	مَقَرّ,مِقْرَى
مقرة	مَقَرّ
مقرون	مَقْرُون
مقرى	مَقَرّ,مِقْرَى
مقري	مَقَرّ,مِقْرَى
مقرية	مَقَرّ
مقلاص	NEWMORPH
مقلص	مُقَلِّص
مقمل	مُقْمَل
مقنا	NEWMORPH
مقناص	NEWMORPH
مقولة	مِقْوَل,مَقُولَة,مَقُول
مكا	NEWMORPH
مكادة	NEWMORPH
مكة	مَكَّة
مكتومة	مَكْتُوم
مكحول	NEWMORPH
مكران	مَكَرّ
مكرم	مَكْرَم,مُكَرَّم
مكروثا	NEWMORPH
مكز	NEWMORPH
مكس	مَكْس,مَكَس-ِ,مَكَّس
مكشحة	NEWMORPH
مكمن	مَكْمَن
مكناسة	مِكْناس
مكنونة	مَكْنُون
مكيمن	NEWMORPH
ملاح	مِلْح,مَلّاح,مَلِيح
ملاص	NEWMORPH
ملاظ	NEWMORPH
ملاع	NEWMORPH
ملاق	مَلّاق,مَلْقَى
ملالة	مَلالَة,مَلال,مُلال
ملبران	NEWMORPH
ملتان	مُلَّة,مَلّ
ملتذ	NEWMORPH
ملتوى	مُلْتَوِي,مُلْتَوَى
ملج	مَلَج,مَلْج
ملجان	NEWMORPH
ملجكان	NEWMORPH
ملح	مَلُح,مُلِحّ,مَلَّح,مِلْح,مَلَح-َُ,مُلْحَة
ملحا	مَلُح,مُلِحّ,مَلَّح,مِلْح,مَلَح-َُ,مُلْحَة
ملحاء	أَمْلَح
ملحان	مُلِحّ,مِلْح
ملحة	مُلِحّ,مِلْحَة,مَلَّح,مِلْح,مُلْحَة
ملحتان	مُلِحّ,مِلْح
ملحوب	NEWMORPH
ملزق	NEWMORPH
ملشون	NEWMORPH
ملطاط	NEWMORPH
ملطمة	مَلْطَم
ملطية	NEWMORPH
ملفون	NEWMORPH
ملقاباذ	NEWMORPH
ملقس	NEWMORPH
ملقونية	NEWMORPH
ملك	مَلَك-ِ,مَلِك,مِلْك,مَلَّك,مَلّ,مُلْك
ملكان	مَلِك
ملكوم	NEWMORPH
ملل	مِلَّة,مُلَّة,مَلَل
ملمار	NEWMORPH
ملنجة	NEWMORPH
ملهم	مُلْهَم,مَلّ
ملود	NEWMORPH
ملوندة	NEWMORPH
ملوية	مَلْوِيّ,مَلَو
مليانة	NEWMORPH
مليبار	NEWMORPH
مليج	NEWMORPH
مليح	مَلِيح
مليحة	مَلِيح
مليحيب	NEWMORPH
مليص	مَلِيص
مليع	NEWMORPH
مليلة	مَلِيلَّة
ممدوداباذ	NEWMORPH
ممروخ	NEWMORPH
ممسى	مُمْسِي,مُمْسَى
ممطير	NEWMORPH
منابض	مَنْبِض
مناة	مَناة,مَنَى-ِ,مَنّ,مَنَى,مَنَّى
مناذر	NEWMORPH
مناز	NEWMORPH
مناع	مَنْعَى
مناف	مُنافِي,مَنْفَى
منبج	NEWMORPH
منبجس	NEWMORPH
منبسة	NEWMORPH
منبوبة	NEWMORPH
منتاب	NEWMORPH
منتخر	NEWMORPH
منتيشة	NEWMORPH
منجان	NEWMORPH
منجح	NEWMORPH
منجخ	NEWMORPH
منجل	مِنْجَل
منجور	مَنْجُور
منجوران	مَنْجُور
منخر	مَنْخَر
مند	NEWMORPH
مندب	مَنْدَب
مندد	مُنَدِّد
مندكؤر	NEWMORPH
مندل	مَنْدَل
مندوب	مَنْدُوب
منديس	NEWMORPH
منزر	NEWMORPH
منستير	مُنَستِير
منشد	مُنْشِد
منشم	NEWMORPH
منصح	NEWMORPH
منضح	مِنْضَح
منعج	NEWMORPH
منغ	NEWMORPH
منف	NEWMORPH
منفلوط	NEWMORPH
منفوحة	NEWMORPH
منفية	مَنْفِيّ
منقباط	NEWMORPH
منقشلاغ	NEWMORPH
منكث	NEWMORPH
منكثة	NEWMORPH
منكف	NEWMORPH
منهات	NEWMORPH
منهل	مَنْهَل
منواث	NEWMORPH
منور	مَنْوَر,مُنَوَّر
منورقة	NEWMORPH
منوف	NEWMORPH
منوقان	NEWMORPH
منونيا	NEWMORPH
منى	مُنَى,مَنَى-ِ,مَنّ,مِنَى,مَنَّى,مِن,مَنَى
مني	مُنَى,مَنَى-ِ,مَنّ,مِنَى,مَنَّى,مِن,مَنَى
منيح	NEWMORPH
منيحة	NEWMORPH
منيذ	NEWMORPH
منيرة	مُنِيرَة,مُنِير
منيع	مَنِيع
منيم	NEWMORPH
منيمون	NEWMORPH
منين	مَنَى-ِ,مَنَّى
منيونش	NEWMORPH
مهاباذ	NEWMORPH
مهايع	NEWMORPH
مهجرة	مَهْجَر
مهجور	مَهْجُور
مهرات	مُهْرَة
مهران	مُهْر,مَهْران
مهربارات	NEWMORPH
مهربانان	NEWMORPH
مهربندقشاي	NEWMORPH
مهرة	مَهْر,مُهْرَة,مُهْر,ماهِر
مهرجان	مُهَرِّج,مَهْرَجان
مهرجمين	NEWMORPH
مهرقان	مَهْرَقان,مَهْرَق,مُهْرَق
مهروان	NEWMORPH
مهروبان	NEWMORPH
مهروذ	NEWMORPH
مهريجان	NEWMORPH
مهريجرد	NEWMORPH
مهزور	NEWMORPH
مهزول	مَهْزُول
مهساع	NEWMORPH
مهشمة	مُهَشَّم
مهفيروزان	NEWMORPH
مهور	مَهْر
مهيعة	NEWMORPH
مهينة	مَهِين,مُهِين
مواشل	NEWMORPH
مواضيع	مَوْضُوع
موالقاباذ	NEWMORPH
موبولة	NEWMORPH
مؤتة	NEWMORPH
موثب	NEWMORPH
مودا	NEWMORPH
مودوع	NEWMORPH
مور	مُور
مورة	NEWMORPH
مورق	مُوَرِّق,مُورِق
موريان	NEWMORPH
موزار	NEWMORPH
موزر	NEWMORPH
موزع	مُوَزِّع,مُوَزَّع
موزن	NEWMORPH
موزور	NEWMORPH
موسل	NEWMORPH
موسى	مُوسَى
موسياباذ	NEWMORPH
موش	NEWMORPH
موشة	NEWMORPH
موشوح	NEWMORPH
موشوم	NEWMORPH
موشيل	NEWMORPH
موضوع	مَوْضُوع
موظب	NEWMORPH
موقان	NEWMORPH
موقر	مُوَقَّر
موقع	مَوْقِع,مُوَقَّع,مُوَقِّع
موقوع	NEWMORPH
موكل	مُوَكَّل,مُوَكِّل
مولتان	NEWMORPH
مولس	NEWMORPH
مونة	مُونَة,مَوَّن
موهبة	مَوْهِبَة
مويسل	NEWMORPH
مياة	ماء
مياسر	مَيْسَرَة
ميافارقين	NEWMORPH
ميانج	NEWMORPH
ميانش	NEWMORPH
ميانه	مَيّان
ميبذ	NEWMORPH
ميبر	NEWMORPH
ميث	NEWMORPH
ميثاء	NEWMORPH
ميثب	NEWMORPH
ميثم	NEWMORPH
ميجاس	NEWMORPH
ميدان	مَيْدان
ميدعا	NEWMORPH
ميدعان	NEWMORPH
ميذق	NEWMORPH
ميرتلة	NEWMORPH
ميرماهان	NEWMORPH
ميزده	NEWMORPH
ميسارة	NEWMORPH
ميسان	مَيَسان
ميسر	مَيْسِر,مُيَسَّر
ميسون	مَيْسُون
ميشار	NEWMORPH
ميشجان	NEWMORPH
ميشه	NEWMORPH
ميطان	مَيْط
ميغ	مِيج
ميغن	NEWMORPH
ميلاص	NEWMORPH
ميلة	مِيل,مَيْل,مَيَّل
ميمة	مِيم
ميمذ	NEWMORPH
ميمنة	مَيْمَنَة,مُيَمَّن
ميمند	NEWMORPH
ميمون	مَيْمُون
ميناء	مِيناء,مِينا
مينان	NEWMORPH
ميناو	NEWMORPH
مينز	NEWMORPH
ميها	NEWMORPH
ميهنة	NEWMORPH
ميوان	NEWMORPH
ميورقة	NEWMORPH
نابت	ناب
نابع	نابِع
نابل	نابِل
نابلس	نابُلُس
ناتلة	NEWMORPH
ناجرة	أَجَر
ناجية	ناجِي
ناحية	ناحِيَة,ناحِي
نارغيسة	NEWMORPH
نارناباذ	NEWMORPH
ناس	ناس,ناسِي,أَسِي-َ,أَسا
ناسر	أَسَر-ِ
ناشروذ	NEWMORPH
ناصح	ناصَح,ناصِح
ناصحة	ناصَح,ناصِح
ناصع	ناصِع
ناصفة	ناصِف,ناصَف
ناضحة	NEWMORPH
ناطلوق	NEWMORPH
ناطلين	NEWMORPH
ناظرة	ناظَر,ناظِر,ناظِرَة
ناعب	NEWMORPH
ناعت	NEWMORPH
ناعتون	NEWMORPH
ناعجة	NEWMORPH
ناعر	NEWMORPH
ناعط	NEWMORPH
ناعم	ناعِم
ناعورة	ناعُور,ناعُورَة
نافخش	NEWMORPH
نافع	نافِع
نافقان	نافِق
نامش	NEWMORPH
نامشة	NEWMORPH
نامية	نامِي
نامين	نامِي
نايت	NEWMORPH
نائلة	نائِل,نائِلَة
نائن	NEWMORPH
ناينج	NEWMORPH
نائين	ناءَى
نبات	أَبات,نَبات
نباتي	نَبات,نَباتِيّ
نباح	أَباح,نُباح,نَبّاح
نباذان	NEWMORPH
نبارة	بارَى
نباع	أَباع,بيع
نباك	NEWMORPH
نباكة	NEWMORPH
نبالة	نَبّال,بالَى,نَبِيل,نَبالَة,نَبْل
نبايع	بايَع
نبتل	بَتَل-ُِ,ٱِبْتَلَى,ٱِبْتَلّ,بَتَّل
نبر	بَرّ-ِ,أَبَرّ,نِبْر,بَرَى-ِ,نَبْر,أَبار,بار,نَبَر-ِ
نبرة	أَبَرّ,نَبْرَة,نِبْر,نَبْر,بَرَى-ِ,أَبار,نَبَر-ِ
نبط	نَبَطِيّ,نَبَّط,نَبْط,بَطّ,نَبَط
نبطاء	NEWMORPH
نبعة	باع-ِ,نَبْع,نَبَع-َُِ,أَباع
نبق	نَبَق,بَقِي-َ,بَقّ,أَبْقَى,نَبْق,وَبَق
نبهان	نَبِه
نبهانية	NEWMORPH
نبوان	NEWMORPH
نبيع	باع-ِ,أَباع
نثرة	نَثْر,نَثَر,ثار,وَثَر-ِ,ثَرِي-َ,أَثار,ثَرّ,نَثَّر,نَثْرَة,أَثْرَى
نجار	نَجّار,جارَى,أَجار,نُجار
نجاكث	NEWMORPH
نجال	أَجال
نجانيكث	NEWMORPH
نجاويز	NEWMORPH
نجب	نَجُب,جَبَى-ِ,وَجَب-ِ,جَبَّى,جاب,نَجْب,جَبّ,أَجاب
نجبة	جَبَى-ِ,جَبَّى,نَجْب,جاب,جَبَه-َ,جَبّ,أَجاب
نجد	وَجَد-ِ,أَجْدَى,جَدا,نَجَد,نَجِد-َ,نَجْد,أَجَدّ,جاد,نَجَّد,أَجاد,جَدّ-ِ
نجدان	NEWMORPH
نجر	جار,نَجَر,أَجار,نَجْر,أَجْرَى,جَرَى-ِ,أَجَرّ,جَرّ
نجران	نَجْران
نجل	نَجَل,جَلا,أَجْلَى,جَلَى-ِ,جال,جَلّ-ِ,نَجْل,جَلَّى,أَجال,أَجَلّ
نجه	جَهِي-َ
نجوة	نَجَّى,نَجْو,نَجْوَة,نَجا,جَوِي-َ
نجيرم	NEWMORPH
نحا	نَحا
نحائت	NEWMORPH
نحل	نَحَل-َ,أَحَلّ,أَحال,نَحِيل,نَحُل,حَلُو,نَحَل-َُ,نَحِل-َ,ناحِل,حَلّ-ِ,حَلَى,حَلَّى,حَلِي-َ,نَحْل,نِحْلَة,حال,حَلّ
نحيزة	نَحِيزَة,حاز-ِ
نخال	خالّ,خال-َ
نخب	خَبّ,نَخْب,خَبا,خاب-ِ,نَخَب,نُخْبَة,أَخاب,خَبّ-َ
نخجوان	NEWMORPH
نخذ	NEWMORPH
نخرة	نَخْر,نَخَر,خار,خار-ِ
نخشب	خَشَّب
نخل	أَخْلَى,خال-َ,نَخَل,خَلّ,خَلا,نَخْل,أَخال,أَخَلّ,خَلَّى
نخلا	نَخَل,نَخْل
نخلان	NEWMORPH
نخلتان	نَخْل
نخلى	أَخْلَى,نَخْل,خَلَّى
نخيرجان	NEWMORPH
نخيل	خَيَّل,نَخِيل,نَخْل,أَخال
ند	نَدّ,نِدّ,نَدّ-ِ,وَدَى-ِ
ندا	نَدّ,نِدّ,نَدا,نَدّ-ِ
ندامان	NEWMORPH
ندرة	أَدْرَى,أَدار,دَرَى-ِ,أَدَرّ,نَدْرَة,نَدْر,دار
نذش	NEWMORPH
نرز	رَزّ,راز,أَرَزّ
نرس	رَسا,أَرْسَى,رَسَّى
نرسيان	NEWMORPH
نرماسير	NEWMORPH
نرمق	رَمَق,رَمَّق
نريان	NEWMORPH
نريز	NEWMORPH
نزعة	نَزْعَة,نَزْع,نَزَّع,نَزَع-ِ
نزل	زال-َ,نَزِل-َ,نَزَل-ِ,أَزال,نَزْل,أَزَلّ,نُزْل,زال,نَزَّل,زَلّ-َِ
نزوة	نَزا,زَوَى-ِ,زَوَّى,نَزّ-ِ,نَزْوَة
نسا	NEWMORPH
نساح	أَساح
نستر	سَتَر,سَتَّر
نسترو	NEWMORPH
نسجان	NEWMORPH
نسر	نَسْر,أَسَرّ,أَسار,سَرّ,أَسْرَى,سَرَى-ِ,سَرَّى,سار-ِ
نسع	سَعَى-َ,وَسِع-َ
نسف	نَسَف-ِ,نَسْف,سَفَى-ِ,أَسْفَى,أَسَفّ
نسفان	NEWMORPH
نسل	نَسَل,سَلا,سَلّ,سَلَّى,أَسْلَى,سال-ِ,نَسْل,نَسَّل,أَسال
نسنان	NEWMORPH
نسيح	سَيَّح,ساح-ِ,أَساح
نشاستج	NEWMORPH
نشاق	NEWMORPH
نشبونة	NEWMORPH
نشتبرى	NEWMORPH
نشك	وَشَى-ِ,شَكا,شَكّ,شاك,نَشّ-ِ,أَشاك
نشم	وَشَم-ِ,شَمّ,شام-ِ
نشوءة	شَأَو,نُشُوء
نشور	شَوَّر,نُشُور
نشوى	نَشْوِيّ,نَشَوِيّ,شَوَى-ِ,نَشْوان
نشير	أَشار
نصاع	NEWMORPH
نصراباذ	NEWMORPH
نصيبين	نَصِيبِين,نَصِيب
نصيل	NEWMORPH
نضاد	ضادّ
نضدون	NEWMORPH
نضل	نَضَل,ضَلّ,أَضَلّ
نطاة	نَطّ
نطاع	أَطاع
نطح	طاح,أَطاح,نَطْح,نَطَح-َ,طاح-ِ
نطروح	NEWMORPH
نطنزة	NEWMORPH
نعام	نَعام
نعامة	نَعام
نعائم	نَعِيم,نَعام
نعل	نَعَل-َ,أَعال,نَعْل,أَعْلَى,عال-ِ,عال,نَعَّل,عَلا,نَعِل-َ,عَلَّى
نعم	نَعِم-َ,عَمِي-َ,عَمّ,عام,نِعْمَة,نَعَّم,نَعُم,نِعْم,نَعَم-َُ,عَمَّى,أَعْمَى,نَعَم
نعماباذ	NEWMORPH
نعمان	نُعْمان
نعمايا	NEWMORPH
نعمة	عَمِي-َ,عام,نِعْمَة,عَمِه-َ,نَعَّم,نِعْم,نَعَم-َُ,نَعْمَة,عَمَّى,أَعْمَى
نعمي	عَمِي-َ,نِعْمَة,نِعْم,نُعْمَى,عَمَّى,أَعْمَى
نعوان	NEWMORPH
نعوة	نَعَى-َ,عَوَى-ِ,مُعاوَنَة,نَعَى-ِ
نعيج	NEWMORPH
نغر	غار,أَغار,أَغْرَى,وَغَر-ِ,غَرا,غَرّ,غَرَّى
نغوبا	NEWMORPH
نغيا	نَغْي,نَغَى-ِ
نفار	أَفار
نفر	فَرَّى,نَفَّر,نَفَر,وَفَر-ِ,أَفْرَى,فَرَى-ِ,أَفَرّ,فار,نافِر,فَرّ-ِ,أَفار
نفراء	NEWMORPH
نفزاوة	NEWMORPH
نفزة	أَفَزّ,فاز,فَزّ-ِ
نفطة	نَفْطَة,نُفَطَة,نَفْط
نفنف	نَفْنَف
نفوسة	نَفْس
نفي	نَفَى,نَفِيّ,نَفْي,وَفَى-ِ
نفيس	نَفِيس
نقار	نُقْرَة,نَقّار
نقان	NEWMORPH
نقائع	NEWMORPH
نقب	قَبا,نَقَّب,وَقَب-ِ,قَبَّى,نَقَب,نَقْب,قاب,نَقِب,نِقاب,قَبّ
نقبون	NEWMORPH
نقجوان	NEWMORPH
نقدة	قَدّ,وَقَد-ِ,قَدا,نَقَد,أَقاد,قاد,قَدِي-َ,ناقِد,نَقْد
نقذة	وَقَذ-ِ,نَقَذ,أَقْذَى
نقر	نَقَّر,قَرّ-َِ,وَقَر-ِ,قَرَى-ِ,نَقِر,نُقْرَة,أَقَرّ,نَقَر,نَقْر,قَرا,نَقِر-َ
نقران	نَقِر,نَقْر
نقرى	قَرَى-ِ,نَقِر,نُقْرَة,نَقْر,قَرا
نقعاء	NEWMORPH
نقم	نَقِم-َ,نَقْمَة,قام,قَمّ,نَقَم-ِ,أَقام
نقمى	نَقْمَة
نقنس	NEWMORPH
نقو	قَوِي-َ,قَوَّى,أَقْوَى
نقواء	NEWMORPH
نقي	وَقَى-ِ,نَقِي-َ,نَقّ,نَقِيّ,نَقَّى
نقيا	نَقِي-َ,نَقِيّ,نَقَّى
نقيب	نَقِيب
نقيد	قَيَّد,أَقاد
نقيرة	قَيَّر,نَقِيرَة,نَقِير
نقيزة	NEWMORPH
نقيع	نَقِيع
نقيوس	NEWMORPH
نكبون	NEWMORPH
نكث	كَثّ-ِ,نَكَث,نَكْث
نكر	نَكِر,نُكْر,كَرِي-َ,كَرَى-ِ,أَكْرَى,نَكَّر,كَرّ,كَرا,نَكِر-َ
نكيدا	NEWMORPH
نكيف	NEWMORPH
نمار	مارَى,أَمار
نمذاباذ	NEWMORPH
نمذيان	NEWMORPH
نمر	مار,مار-ِ,أَنْمَر,نَمَّر,مَرّ,نَمِر,أَمَرّ,أَمار
نمرة	مار,مار-ِ,نَمَّر,أَنْمَر,مَرّ,نُمْرَة,نَمِر,نِمْرَة,أَمَرّ,أَمار
نمرى	أَنْمَر,نَمِر
نمكبان	NEWMORPH
نملى	نَمْل,أَمْلَى,نَمَل,مَلَّى,نَمِل,نَمْلِيّ
نميرة	مار-ِ,أَمار
نميسة	ماس-ِ
نميط	ماط-ِ,أَماط
نميلة	أَمال,مَيَّل
نها	نَها
نهاب	هاب-َ,أَهاب,نَهّاب
نهاوند	NEWMORPH
نهبان	NEWMORPH
نهران	نَهْر
نهروان	NEWMORPH
نهم	وَهَم-ِ,هَمّ,أَهَمّ,هَما,نَهِم,نَهِم-َ,هام-ِ,نَهَم
نهوذ	NEWMORPH
نهي	نَهْي,وَهَى-ِ,نُهَى,نَهَى-ِ
نهيا	نَهْي,نَهَى-ِ
نهية	نُهْيَة,وَهَى-ِ,نَهْي
نوا	NEWMORPH
نوادة	وادّ,نُواد
نوادر	نادِرَة
نوار	وارَى,نُوّار
نواز	وازَى-ِ
نوب	نَوْبَة,نُوبَة,نَوَّب
نوباذان	NEWMORPH
نوباغ	NEWMORPH
نوبة	وَبَه-َ,نَوْبَة,أَوْبَه,نُوبَة,نَوَّب,نُوبِيّ
نوبذ	NEWMORPH
نوبنجان	NEWMORPH
نوبندجان	NEWMORPH
نوبهار	NEWMORPH
نوجاباذ	NEWMORPH
نوجكث	NEWMORPH
نوخس	NEWMORPH
نودز	NEWMORPH
نوذ	NEWMORPH
نور	نُور,نَوَر,أَوْرَى,نَوَّر,وَرَّى
نورد	أَوْرَد,وَرَّد
نوز	وَزّ
نوزاباذ	NEWMORPH
نوزكاث	NEWMORPH
نوسا	نَوْس
نوش	وَشَّى
نوشار	NEWMORPH
نوشجان	NEWMORPH
نوشهر	NEWMORPH
نوفر	أَوْفَر,وَفُر,وَفَّر
نوق	ناقَة
نوقات	NEWMORPH
نوقان	NEWMORPH
نوقد	وَقَّد,أَوْقَد
نوكذك	NEWMORPH
نوكند	NEWMORPH
نول	نَوْل,نَوَّل,وَلَّى,أَوْلَى
نولة	وَلِه-َِ,نَوْل,نَوَّل,وَلَّى,أَوْلَى,وَلَّه,أَوْلَه
نوند	NEWMORPH
نويرة	NEWMORPH
نويزة	NEWMORPH
نويطف	NEWMORPH
نويعة	NEWMORPH
نيار	NEWMORPH
نيازي	NEWMORPH
نياستر	NEWMORPH
نياع	نَيْع
نيان	نِيّ
نيبطون	NEWMORPH
نيرب	NEWMORPH
نيربا	NEWMORPH
نيرمان	NEWMORPH
نيروز	NEWMORPH
نيروه	NEWMORPH
نيريز	NEWMORPH
نيسابور	NEWMORPH
نيقية	نَيِّق
نيلاب	NEWMORPH
نيلاط	NEWMORPH
نيمروز	NEWMORPH
نينوى	نِينَوِيّ,نِينَوَى
نيني	NEWMORPH
نيه	نِيّ,نَيّ,نِيَّة
هاب	هاب-َ
هارة	هار
هاروت	NEWMORPH
هاش	هاش,هاشّ,هاش-ِ
هاطرى	NEWMORPH
هبالة	NEWMORPH
هبراثان	NEWMORPH
هبزتان	NEWMORPH
هبكات	NEWMORPH
هبل	هِبَلّ,أَهْبَل,هَبِل-َ
هبود	NEWMORPH
هبيرة	هُبَيْرَة
هترونة	NEWMORPH
هجر	هَجَر,هَجَّر,هَجْر
هجول	NEWMORPH
هدن	هاد,هَدَن-ِ,هَدَّن
هدى	هَدْي,هَدَى-ِ,هَدّ,هُدَى
هراة	هَرا,هَراة,هَرّ-ِ
هراميت	NEWMORPH
هران	NEWMORPH
هرجاب	NEWMORPH
هرشى	هَرْش
هرشير	NEWMORPH
هرقلة	NEWMORPH
هركام	NEWMORPH
هركند	NEWMORPH
هرمة	هَرِم,هَرَّم,هَرَم
هرمز	NEWMORPH
هرمزجرد	NEWMORPH
هرمزغند	NEWMORPH
هرمزفره	NEWMORPH
هرمشير	NEWMORPH
هرند	NEWMORPH
هروب	هُرُوب
هرور	NEWMORPH
هزاراسب	NEWMORPH
هزمان	NEWMORPH
هزمة	هَزْم,هَزَم-ِ
هزو	NEWMORPH
هسنجان	NEWMORPH
هضاب	هَضْبَة
هضاض	NEWMORPH
هضام	NEWMORPH
هضب	هَضَب-ِ
هضيم	هَضِيم
هفتاد	NEWMORPH
هفتان	هَفْتان
هفتجرد	NEWMORPH
هفترك	NEWMORPH
هفرفر	NEWMORPH
هفندى	NEWMORPH
هكة	NEWMORPH
هكر	هَكِر-َ
هكران	NEWMORPH
هلال	هِلال
هلباء	أَهْلَب
هلثا	NEWMORPH
هلس	هَلَس-ِ,هَلَّس,هَلْس
هلورس	NEWMORPH
همانية	NEWMORPH
همد	هَمَّد,هَمَد
همذان	NEWMORPH
همزى	هَمْز
همينيا	NEWMORPH
هنا	هُنا,هَنّ-ِ
هنتل	NEWMORPH
هندمند	NEWMORPH
هندوان	NEWMORPH
هنديجان	NEWMORPH
هنزيط	NEWMORPH
هنكام	NEWMORPH
هنن	هَنّ-ِ
هني	هَنِيّ
هنيدة	NEWMORPH
هنين	NEWMORPH
هو	هُوَ,هُو
هوب	NEWMORPH
هوبر	NEWMORPH
هورقان	NEWMORPH
هوزن	NEWMORPH
هوسم	NEWMORPH
هوفان	NEWMORPH
هولى	هَوْل
هونين	NEWMORPH
هيان	NEWMORPH
هيت	هَيْتَ,هِيت,هَيَّت
هيثم	هَيْثَم
هيثماباذ	NEWMORPH
هيج	هَيْج,هَيَّج
هيد	NEWMORPH
هيدة	NEWMORPH
هير	هَيِّر,هَيَّر
هيسان	NEWMORPH
هيطل	هَيْطَل
هيلاء	NEWMORPH
هيلاقوس	NEWMORPH
هيلان	هَيَلان
هيوة	NEWMORPH
وابش	باش,بَشّ-َ
وابصة	بَصّ-ِ,بَصّ
وابكنة	NEWMORPH
وابل	بَلّ-ِ,إِبْل,بَلا,بال,بَلِي-َ,أَبَلّ,وَبَل-ِ,بَلّ,أَبال,أَبْلَى,وابِل
واتدة	NEWMORPH
واثلة	أَثْل,ثَلّ,أَثْلَة,أَثَّل,أَثَل-ِ
واحد	أَحَد,حاد-ِ,حاد,حَدّ-ِ,حَدّ,واحِد,أَحَّد,حَدِي,أَحَدّ,حَدا
واحف	حَفّ-ِ,حَفّ,حاف-ِ,حَفِي-َ
واذار	آذار
واذنان	إِذْن,آذِن,أُذُن
واران	NEWMORPH
واردات	وارِد
وازذ	NEWMORPH
وازواز	NEWMORPH
واسط	ساط,سَطا
واسم	وَسَم-ِ,سَمّ,ٱِسْم,سام,سَما,أَسام,سَمَّى,أَسْمَى
واشجرد	NEWMORPH
واشلة	شال-ِ,أَشَلّ,شَلّ,أَشال,شال
واضع	ضاع-ِ,واضِع,وَضَع,أَضاع,ضاع
واعقة	أَعَقّ,أَعاق,عَقّ,عاق,عَقِيق
واقرة	قَرّ-َِ,وَقَر-ِ,قَرَى-ِ,أَقَرّ,قَرا
واقس	قَسَّى,أَقْسَى,قَسا,قَسّ,قاس-ِ
واقصة	قَصا,وَقَص-ِ,قَصّ,قَصِي-َ,أَقْصَى
واقف	قَفّ,قَفَّى,قَفا,واقِف,وَقَف-ِ,قَفاً
واقم	قام,قَمّ,أَقام
واقية	وَقَى-ِ,واقِي,واقِيَة
واكنة	كَنا,كَنّ-ِ,كَنّ,أَكَنّ,كَنَى-ِ,كَنَّى,كان
والبة	أَلَب,لاب,لَبّ,لَبَّى,أَلَّب
والس	أَلَّس,وَلَس-ِ,لاس,والَس
والع	لاع
والغ	أَلْغَى,وَلَغ-َ,لَغا,لَغِي-َ
والغين	أَلْغَى,غَيْن
والولجة	NEWMORPH
وان	إِنَّ,أَن,وَنَى-ِ,آن,وَإِن,أَنّ-ِ,أَنَّ,إِن
وانبة	أَنْبَه,نَبُه,نَبَّه,ناب,نَبا,أَنَبَة,أَناب,أَنَّب,نَبِه-َ,نَبَه
وانشريش	NEWMORPH
واهب	هاب-َ,أَهاب,واهِب,هَبّ,هَبا,أَهَبّ,إِهاب,أَهَّب,وَهَب-َ,أُهْبَة
وايل	أَيِّل,آيِل,وايِل
وبار	بارّ,بار,آر
وبال	آل,بالِي,بال,ال,إِل,وَبال
وبذة	بَذّ
وبذى	بَذّ,ذِي
وبرة	بِرّ,بُرّ,وَبِر,وَبَر,بَرّ
وبعان	عانِي
وتر	وَتَر-ِ,وَتَّر,رَأَى-َ,وِتْر,وَرَى-ِ,وَتَر
وج	ج
وجر	جَرّ,وَجْر
وجرة	جَرَّة,جَرّ,وَجْرَة,جُرَّة,وَجْر
وجرى	جَرْي,جَرّ,وَجْر,جَرَى-ِ
وجمة	جَمّ,وَجِم,جَمّ-ُِ
وجمى	جَمّ,وَجِم
وجه	وَجَّه,وَجْه
وح	ح
وحا	NEWMORPH
وحاظة	NEWMORPH
وحدة	حِدَة,حِدَّة,حَدّ,وَحْد,وَحْدَة,وَحَّد
وحفاء	NEWMORPH
وحيف	حَيْف
وخاب	خاب-ِ
وخدة	خُدَّة,خَدّ
وخش	خَشّ
وخشمان	NEWMORPH
وخفان	خُفّان,خُفّ
ود	وَدّ-َ,د,وُدّ
وداعة	وَداعَة,وَداع
ودان	دانِي,دان-ِ
ودج	وَدَج,دُجّ,دَجّ-ِ
ودحان	NEWMORPH
ودعان	NEWMORPH
ودقان	دِقّ
وذار	NEWMORPH
وذرة	وَذِر-َ,ذَرَّة,ذُرَة,ذَرّ
وذفة	NEWMORPH
وذلان	NEWMORPH
وذنكاباذ	NEWMORPH
وراخ	راخِي
ورازان	NEWMORPH
ورازون	NEWMORPH
وراقان	وَرّاق
وراليز	NEWMORPH
ورام	رامِي,رام-ِ,رام
ورامين	رامِي,رامِين
وراوي	راوِي
ورتنيس	NEWMORPH
ورثال	NEWMORPH
ورثان	رَثّ
ورثين	رَثَى,رَثّ
ورجلان	رَجُل,رِجْل
وردان	NEWMORPH
وردانة	NEWMORPH
ورذان	NEWMORPH
ورذانة	NEWMORPH
ورز	رَزّ,رُزّ
ورزنين	NEWMORPH
ورسك	وَرْس
ورسنان	رَسَن
ورسنين	رَسَن
ورشة	وَرْشَة,رَشَّة,وَرِش,وَرَش-ِ,وَرَّش,رَشّ
ورعجن	NEWMORPH
ورغسر	NEWMORPH
ورقود	راقِد,رُقُود
وركان	وَرْك
وركة	رِكَّة,رَكّ,رُكَّة,وَرْك
وركن	رَكِن-َ,رُكْن,رَكَن
وركوه	رَكْوَة,رَكّ
ورنتل	NEWMORPH
ورنخل	NEWMORPH
ورندان	NEWMORPH
وره	NEWMORPH
ورور	NEWMORPH
وزاغر	NEWMORPH
وزدول	NEWMORPH
وزوالين	NEWMORPH
وزوان	زُوان,زانِيَة
وزوين	زَوَى-ِ,زَوَّى
وسادة	سَيِّد,ساد,دَهَى-َ,دَهَّى,سادّ,وِسادَة,دَهِي-َ,وَساد,سادَة,وَدَى-ِ
وساع	ساعِي,وَعَى-ِ
وسافردر	NEWMORPH
وسخاء	سَخاء
وسسكر	NEWMORPH
وسط	وَسَّط,وَسْطَ,وَسْط
وسطان	NEWMORPH
وسقند	NEWMORPH
وسواس	سائِس,وَسْواس
وسوس	سَوَّس,وَسْوَس,سَوِس-َ,سُوس
وسيج	سَيَّج
وسيع	وَعَى-ِ,وَسِيع
وسيم	وَسِيم
وشترة	شَتَر-ِ
وشجى	شَجاً,شَجِي,شَجَّى,شَجِيّ,شَجِي-َ
وشحاء	NEWMORPH
وشقة	وَشَق,شِقّ,شَقّ,شَقَّة,شُقَّة
وشيج	وَشِيج
وصاب	صابِي
وصاف	وَصّاف,صافِي
وضاخ	NEWMORPH
وضرة	ضِرّ,ضَرّ,ضَرَّة,وَضَر
وعاب	عاب-ِ
وعال	عال-ِ,عال,عالِي
وعبرة	عَبَّر,عَبْرَ,عَبْر,عَبْرَة,عَبَر,عِبْرَة
وعقة	وَعِق,عَقّ,وَعْق
وعل	عَلَّ,وَعْل
وعلان	عَلّان,وَعْلان
وفدة	وَفْد,وَفَد-ِ,وَفَّد
وفراء	فَرْوَة,فَراء,فَرّاء
وقبان	قَبّان,وَقْب,قَبّ
وقش	قَشّ
وقط	قِطّ,قَطّ
وقف	قَفّ,وَقْف,وَقَّف,وَقَف-ِ
وقير	قِير,قَيَّر
وقيط	NEWMORPH
وكار	كار,آر
وكد	وَكَّد,وَكْد,كَدّ
وكراء	راء,كِراء,رائِي
ولاستجرد	NEWMORPH
ولاشجرد	NEWMORPH
ولعان	لَعْنَة,وَلِع,لِعان,عانِي
ولغون	لَغا
ولمة	لَمّ,لُمَّة,لِمَّة,لَمَّة
ولوالج	NEWMORPH
وليداباذ	NEWMORPH
وليلى	وَلِي-ِ,لَيْلَى,لَيْل,لَيْلِيّ
ون	وَنّ-ِ,وَنّ,ن
ونج	NEWMORPH
ونجر	نَجَر,أَجار,نَجْر,جَرّ,أَجَرّ,جار,أَجْرَى,جَرَى-ِ
ونداد	NEWMORPH
ونك	وَنّ-ِ,وَنّ,نِك,وَكَى-ِ
ونندون	NEWMORPH
ونه	وَهَى-ِ,وَنّ-ِ,وَنّ
ونوفاغ	NEWMORPH
ونوفخ	NEWMORPH
وهبن	هاب-َ,وَهَب-َ
وهبين	NEWMORPH
وهد	هَدّ-ِ,هَدّ,وَهْدَة,وَهْد,وَهَّد
وهران	وَهْران
وهرندازان	NEWMORPH
وهشتاباذ	NEWMORPH
وهط	NEWMORPH
ويبوذى	NEWMORPH
ويذاباذ	NEWMORPH
ويذار	NEWMORPH
وير	رَأَى-َ,وَرَى-ِ
ويزة	زُهِي-َ,أَزْهَى,زَها
ويسو	سَوَّى,سَوِي-َ
ويمة	أَماه,ماه-و
ويمية	أَماه
وينا	يِن
يابره	أَبَر-ُِ
يابسة	يابِس,يابِسَة
ياجج	أَجّ
ياركث	NEWMORPH
يارم	أَرَم-ِ
يازل	NEWMORPH
يازور	NEWMORPH
ياسر	ياسِر,ياسَر,أَسَر-ِ
ياسرة	ياسِر,أَسَر-ِ
ياسورين	NEWMORPH
ياسوف	NEWMORPH
ياطب	NEWMORPH
يافا	يافا
يافع	يافِع
ياق	NEWMORPH
ياقد	NEWMORPH
ياقين	NEWMORPH
يام	NEWMORPH
يامور	NEWMORPH
يانه	أَنَى-ِ
ياية	ياي
يبة	بَهِي-َ
يبت	بَتّ,بات-ِ,أَبات
يبرود	NEWMORPH
يبرين	بَرَى-ِ
يبمبم	NEWMORPH
يبنبم	NEWMORPH
يبنى	بَنَى-ِ,أَبان
يبوس	باس
يبين	أَبان,بَيَّن,بان-ِ
يترب	تَرَّب,تَرَبَّى,أَتْرَب,تَرِب-َ
يتيب	NEWMORPH
يتيم	يَتِيم,تام,تَيَّم
يثجل	NEWMORPH
يثرب	ثَرَب-ِ,يَثْرِب,ثَرَّب
يثربة	ثَرَب-ِ,ثَرَّب
يثقب	أَثْقَب,ثَقَّب,ثَقَب
يثلث	ثَلَّث
يثمثم	NEWMORPH
يثوب	ثَوَّب,ثاب
يجودة	جاد
يحصب	حَصِب-َ,حَصَب-ُِ,حَصَّب
يحطوط	NEWMORPH
يحمول	NEWMORPH
يحموم	NEWMORPH
يدعان	وَدَع-َ,دَعّ-َ
يدعة	وَدَع-َ,ٱِدَّعَى,دَعّ-َ,دَعا
يدوم	دام,دَوَّم
يديع	NEWMORPH
يذبل	ذَبَل
يذخكث	NEWMORPH
يراخ	NEWMORPH
يرامل	NEWMORPH
يربغ	NEWMORPH
يرثد	NEWMORPH
يرثم	NEWMORPH
يرعة	يَرَع,رَعا,أَراع,أَرْعَى,راع,راع-ِ,رَعَى-َ
يرمرم	NEWMORPH
يرمل	أَرْمَل,رَمَّل
يرملة	رَمَّل
يرموك	يَرْمُوك,رَمَى-ِ,رَمّ
يرنا	رَنّ-ِ,رَأَى-َ,وَرَى-ِ
يرني	رَأَى-َ,وَرَى-ِ,رَنَّى,أَرْنَى
يرولة	رَوَّل
يريض	NEWMORPH
يريم	رام-ِ,رَيَّم
يزد	زاد-ِ,أَزاد
يزداباذ	NEWMORPH
يزدود	NEWMORPH
يزن	وَزَن-ِ,زَنَى-ِ,زان-ِ,زَنّ
يزيد	زاد-ِ,زَيَّد,أَزاد
يزيدان	زاد-ِ,زَيَّد,أَزاد
يسار	أَسار,يَسار,سارّ
يسر	أَسَرّ,أَسار,سَرّ,يَسُر,أَسْرَى,يَسَّر,يَسِر-َ,يُسْر,سار-ِ,سَرَى-ِ,سَرَّى
يسنم	NEWMORPH
يسنوم	NEWMORPH
يسوم	سام,سَوَّم
يسيركث	NEWMORPH
يعار	عار-َ,أَعار
يعر	وَعَر-ِ,عار-َ,عَرّ,عَرَّى,أَعار,عَرا,عار-ِ,عَرِي-َ
يعرج	عَرَج,عَرِج-َ,أَعْرَج,عَرَّج
يعسوب	NEWMORPH
يعمر	عَمَر,عَمَّر,أَعْمَر,عَمُر,عَمِر-َ
يعمون	عَمِي-َ,عَمّ,عَمَّى,أَعْمَى
يعوق	عَوَّق,عاق
يغنى	أَغْنَى,غَنِي-َ,غَنَّى
يغوث	غَوَّث
يفتل	فَتَّل,فَتَل-ِ
يفعان	يَفَع
يفور	فَوَّر,فار
يقن	يَقْن,يَقِن-َ,قَنا,يَقِن,قَنَى-ِ
يك	وَكَى-ِ
يكشوثا	NEWMORPH
يكك	وَكَى-ِ
يلابن	NEWMORPH
يلبن	لاب,لَبَّن
يلدان	وَلَد-ِ,لَدّ
يلملم	لَمْلَم
يليل	NEWMORPH
يم	NEWMORPH
يما	NEWMORPH
يمابرت	NEWMORPH
يمن	مَنّ,مَنا,مَنَّى,يَمَن,يَمِن-َ,مَنَى-ِ,أَمَنّ,يُمْن,يَمُن,يَمَّن
يمني	مَنَّى,يَمَن,مَنَى-ِ,يُمْن,يُمْنَى,يَمَنِيّ
يمؤود	NEWMORPH
يمين	يَمِين
ين	وَنَى-ِ,يِن
ينابع	NEWMORPH
ينابعات	NEWMORPH
يناصيب	NEWMORPH
ينبع	ٱِنْباع,أَنْبَع,يَنْبُع,نَبَع-َُِ
ينبغ	ٱِنْبَغَى,نَبَغ-َُِ
ينبوتة	NEWMORPH
ينجا	NEWMORPH
ينجلوس	NEWMORPH
ينخع	NEWMORPH
ينخوب	NEWMORPH
ينسوع	NEWMORPH
ينسوعة	NEWMORPH
ينشتة	NEWMORPH
ينصوب	NEWMORPH
ينعب	نَعَب-ِ,نَعَب-َ
ينقب	نَقَّب,نَقَب,نَقِب
ينكف	نَكَف,ٱِنْكَفّ
ينكوب	NEWMORPH
ينكير	NEWMORPH
ينوف	ناف
ينوفة	ناف
ينوق	NEWMORPH
ينونش	NEWMORPH
يهرع	هَرَع-َ,أَهْرَع,هَرَّع
يوان	يُوان
يوخشون	NEWMORPH
يوذى	NEWMORPH
يوز	وَزّ
يوزكند	NEWMORPH
يوسان	NEWMORPH
يوغنك	NEWMORPH
يونارت	NEWMORPH
يونان	وَنّ-ِ,يُونان
يؤيؤ	NEWMORPH
ييعث	NEWMORPH
يين	NEWMORPH