##### MuCjam al-buldan 
الآبار	بِئْر
الآجام	أَجَمَة
آرة	آر
آرهن	آر
الآزاج	أَزَج
آزر	آزَر
آسك	آس
آلات	آلَة
آلين	آلَى
آم	آم-ِ
آيل	آيِل
أبان	أَبان
أبراد	بُرْد
الأبرشية	أَبْرَشِيّ
أبرقوه	أَبْرَق
أبزار	بِزْر
أبسس	بَسّ
الأبطح	أَبْطَح
أبغر	بَغَر
أبكن	أَبّ
الأبلق	أَبْلَق
ابند	بَنَّد
أبوان	أَب
أبير	أَبار
الأبيض	أَبْيَض
أتريب	تَرَيَّب
الأتم	أَتَمّ
الأثل	أَثْل
الأثلة	أَثْلَة
إثمد	إِثْمِد
أثوا	أَثّ-َُِ
الأثيرة	أَثِير
أثيل	أَثِيل
الأثيل	أَثِيل
أجان	جانَى
الأجباب	جُبّ
أجداد	جَدّ
أجذال	جِذْل
الأجرد	أَجْرَد
أجياد	جَواد
أحارب	حارَب
الأحاسن	أَحْسَن
أحباب	حَبِيب
الأحدب	أَحْدَب
أحزاب	حِزْب
الأحساء	أَحْساء
الأحسية	حَسْوَة
إحليلي	إِحْلِيل
إحليل	إِحْلِيل
الأحمدي	أَحْمَدِيّ
الأحمر	أَحْمَر
الأحواز	حَوْز
الأحواض	حَوْض
الأحياء	حَيّ
أخا	أَخ
الأخاديد	أُخْدُود
أخزم	خَزَم-ِ
الأخصاص	خُصّ
الأخضر	أَخْضَر
أخطب	خَطَب
أخلاء	خَلِيل
أدامى	أَدّام
الأداة	أَداة
أدقية	أَدَقّ
الأدنيان	أَدْنَى
الأدهم	أَدْهَم
أذبل	ذَبَل
أذربيجان	MANUAL
أدرنت	أَدْرَن
أذلق	أَذْلَق
أذون	إِذْن
أراك	رَأَى-َ
أرانب	أَرْنَب
أرباع	رُبْع
أربد	ٱِرْبَدّ
الأربعاء	أَرْبِعاء
أرتاح	ٱِرْتاح
أرجان	أَرِج
أرجونة	أَرْجُون
الأرحاء	رَحَى
أردبيل	MANUAL
الأردن	MANUAL
أرزن	رَزُن
أرفاد	رِفْد
أركان	رُكْن
أرل	رال-ِ
أرماث	رَمَث
إرم	إِرَم
أرمية	رَمَى-ِ
أرنم	رَنَّم
أرول	رَوَّل
أروم	رام
أرون	أَرُون
أريحا	أَرِيحا
أريض	أَرِيض
أريكة	أَرِيكَة
أرينة	ران-ِ
أزنيك	زَنَى-ِ
الأزوران	أَزْوَر
الأساسان	أَساس
أسالم	سالَم
إستا	ٱِسْت
إستانة	إِسْتانَة
اسحمان	أَسْحَم
أسطوان	أُسْطَى
إسفنج	إِسْفَنْج
إسكاف	إِسْكاف
إسكندرونة	إِسْكَنْدَرُونَة
أسلمان	أَسْلَم
أسنمة	سَنام
أسوارية	إِسْوار
الأسواط	سَوْط
أسوان	MANUAL
الأسورة	سِوار
أسيوط	MANUAL
الأشافي	إِشْفَى
أش	وَشَى-ِ
الأشعر	أَشْعَر
الأشفار	شَفْر
أشكر	شَكَر
الأشل	أَشَلّ
الأشنان	أُشْنان
أشونة	شَوَّن
أشير	أَشار
أشي	وَشَى-ِ
إصبع	إِصْبَع
أصبغ	صَبَغ
الأصنام	صَنَم
أصيل	أَصِيل
أضبع	ضَبْع
أضراس	ضِرْس
أضرعة	ضَرَع
أطد	وَطَد-ِ
أطراف	طَرَف
أطرقا	أَطْرَق
أطواء	طَيّ
أطهار	طاهِر
أطيط	أَطِيط
أظفار	ظُفُر
الأعراف	عُرْف
الأعزلان	أَعْزَل
أعشار	عُشْر
الأعقة	عَقِيق
أعكش	عَكَش-ِ
الأعلم	أَعْلَم
الأعماق	عُمْق
أعناك	أَعان
الأعيان	عَيْن
الأغران	أَغَرّ
الأغر	أَغَرّ
أفاحيص	أُفْحُوص
الأفاعي	أَفْعَى
أفاعية	أَفْعَى
الأفاقة	أَفّاق
إفراغة	إِفْراغ
أفران	فُرْن
إفريقية	MANUAL
الأفلاج	فَلَج
أفيح	أَفْيَح
أفيق	أَفاق
إقدام	إِقْدام
الأقرع	أَقْرَع
الأقعس	أَقْعَس
الأقفاص	قَفَص
الأقلام	قَلَم
إقليد	إِقْلِيد
إقليم	إِقْلِيم
أقور	قَوَّر
إكام	أَكَمَة
الاكام	أَكَمَة
أكباد	كَبِد
الأكناف	كَنَف
الأكواخ	كُوخ
الأكوار	كُور
الأكوام	كَوْم
ألاق	لاقَى
ألعس	أَلْعَس
ألملم	لَمْلَم
ألوذ	لاذ
ألوس	لاس
الأمراء	أَمِير
الأمرار	مُرّ
إمرة	إِمْرَة
الأملحان	أَمْلَح
أمويه	أُمَوِيّ
أمهار	مُهْر
الأميرية	أَمِيرِيّ
الأمين	أَمِين
أناخة	أَناخ
أنار	أَنار
أنحاص	ٱِنْحاص
أندرين	أَنْدَر
أندق	ٱِنْدَقّ
الأندلس	MANUAL
إنسان	إِنْسان
الأنعمان	أَنْعَم
الأنواط	نَوْط
الأنيس	أَنِيس
الأوار	أُوار
أواق	أُوقِيَّة
أوال	والَى
أوجار	وَجْر
أوج	أَوْج
أوجلة	أَوْجَل
أودنة	أَوَّد
الأودية	وادِي
اوراس	أَوْراس
أورال	وَرَل
أورين	أَوْرَى
الأوزاع	أَوْزاع
أوش	وَشَّى
الأوعار	وَعْر
أوعال	وَعْل
أوق	أَوَّق
أومة	أُوم
أونيك	وَنَّى
إهاب	إِهاب
الأهرام	هَرَم
أهلم	هَلَّم
الأهواز	MANUAL
إيران	إِيران
إير	إِير
الأيسر	أَيْسَر
الأيكة	أَيْكَة
أيلة	أَيِّل
الأيم	أَيِّم
الإيوان	إِيوان
أيهم	أَيّ
أية	أَيّ
البئر	بِئْر
بابرتي	إِبْرَة
بابشير	أَبْشِير
بابلا	بابِل
بابليون	بابِلِيّ
باجبارة	إِجْبار
باجسري	جِسْر
باجة	باجَه
باخة	باخ
بادران	دَرَن
بادن	بادِن
باذ	باذّ
باران	بارّ
بارما	بارْما
باروشة	أَرْش
البارة	بارّ
باسلامة	إِسْلام
باسيان	أَسْيان
باشتان	باشّ
باشو	باشّ
باضع	باضَع
باعث	باعِث
باغ	باغِي
باغون	باغِي
باغة	باغَة
باف	إِف
بامردي	أَمْرَد
بانب	أَنَبَة
ببق	بَقّ
ببليون	بِلْيُون
ببنة	بُنّ
بتا	بَتّ
بتران	تران
بثينة	بُثَيْنَة
بجاوة	جاوَه
البجوم	بَجْم
بحثر	بَحْثَر
البحرة	بَحْرَة
بحير	حَيْر
البحيرة	بُحَيْرَة
البخارية	بُخارِيّ
البدائع	بَدِيعَة
بدهة	بَدَه-َ
بديانا	دِيانا
بديع	بَدِيع
البديعة	بَدِيعَة
بذ	بَذّ
بذقون	ذَقْن
البرابي	بِرْبَة
براش	بَراش
براعيم	بُرْعُوم
براقش	بِرْقِش
براكد	راكِد
برباط	رِباط
بربخ	بَرْبَخ
البربر	بَرْبَرِيّ
برث	رَثّ
برجان	بُرْج
البرج	بُرْج
برجلان	بَرْجَل
برخو	رَخْو
البرادان	بَرّاد
برديا	بَرْدِيّ
برديس	بَرْدِيس
برذعة	بَرْذَعَة
ببرذعة	بَرْذَعَة
برذون	بِرْذَوْن
برس	برِس
برسف	رَسْف
برسيم	بِرْسِيم
برشانة	بُرْشام
برطلى	رَطْل
برطوبة	رُطُوبَة
برغر	بَرْغَر
برقاء	رَقّاء
برقان	بَرْق
البرك	بِرْكَة
برمس	رَمْس
بريش	رِيش
بزار	بَزّار
بزاق	بُزاق
برنان	رَنّان
بزوغى	بُزُوغ
بسا	بَسّ
بسان	سان
البسرة	بُسْر
بس	بَسّ
بسطام	MANUAL
بسكاير	سِيكارَة
بسيان	سِيان
بسي	سِي
بشام	شام
بشتان	شَتّان
بشتن	باش
بشيت	شِيت
بشيلة	شَيْلَة
بشنى	شَنّ
بصاق	بُصاق
البصر	بَصَر
البصرة	MANUAL
البصل	بَصَل
البصلية	بَصَلِيّ
بصيدا	صَيْداء
بضاعة	بِضاعَة
البضيض	بَضِيض
البطاح	أَبْطَح
البطانة	بَطانَة
البطائح	بَطِيحَة
البطحاء	أَبْطَح
بطحاء	أَبْطَح
بطحان	طَحّان
بطروح	طَرُوح
بطروش	طَرْش
بطليوس	MANUAL
البطيحة	بَطِيحَة
بعدان	بُعْد
بعرين	عَرِين
بعل	بَعْل
البعوضة	بَعُوض
بغاث	بُغاث
بغث	غَثّ
بغداد	MANUAL
بغلان	بَغْل
بغيث	غَيْث
بقابوس	قابُوس
البقال	بَقّال
بقران	قِران
بقيرة	قِير
بكاس	كاس
البكرات	بَكْرَة
بكرد	كُرْدِيّ
بكيل	كَيْل
بلاس	بلاس
بلاص	بَلّاص
بلجان	لَجْنَة
بلدود	لَدُود
بلطش	لَطْش
بلغار	بُلْغار
بلغي	بُلْغَة
البلقاء	أَبْلَق
بلنسية	MANUAL
البلوط	بَلُّوط
بلهيب	لَهِيب
بليرة	لِيرَة
بم	بِمَ
بنان	بَنان
بنانة	بَنان
البنتان	بِنْت
بنكت	نُكْتَة
بنكث	نَكْث
بنة	بُنّ
بنيان	بُنْيان
البنية	بِنْيَة
بوادر	بادِرَة
بوار	بَوار
بوازن	وازِن
بوازنة	وازِن
بوص	بُوص
بوظة	بُوظَة
بونا	بَون
البويرة	بُوَيْرَة
بهسنا	هَسّ
به	بِ
بيار	بِيار
البياض	بَياض
بيانة	بَيان
بيجان	بِيجان
البيداء	بَيْداء
بيدرة	بَيْدَر
البير	أَلْبِير
بيروت	MANUAL
بيزان	باز
بيستي	بَيْسَة
البيضاء	أَبْيَض
البيضتان	بَيْض
بيل	بِيل
بينون	بِينُون
البينة	بَيِّنَة
البييضة	بُوَيْض
التاج	تاج
التاجية	تاجِيّ
تارم	أَرَم-ِ
تاسن	أَسِن-َ
تاكرونة	أَكَر-ِ
تاكيس	تاكِيس
تامرا	أَمَر
التبر	تِبْر
تبريز	MANUAL
تبغر	بَغَر
تبنان	أَبان
تبوك	تَبّ-ِ
تبيل	أَبال
تثلث	ثَلَّث
تثليث	تَثْلِيث
تجيب	أَجاب
تخاوة	خاوَى
تختم	خَتَم-ِ
تدليس	تَدْلِيس
تدمير	تَدْمِير
تديانة	وَدَى-ِ
تذرب	ذَرِب-َ
ترفلان	رَفَل
تركستان	تُرْكِسْتان
ترمسان	رَمَس
تونجة	تُونج
الترويح	تَرْوِيح
التروية	تَرْوِيَة
ترياق	تِرْياق
تريك	وَرَى-ِ
تضاع	أَضاع
تضارع	ضارَع
تطيلة	أَطال
تعشر	عَشَّر
تعنق	عَنَّق
تعهن	وَعَى-ِ
تغلمان	غَلِم-َ
تغلم	غَلِم-َ
تغوث	غَوَّث
التفرق	تَفَرُّق
تفسرا	فَسَّر
تفليس	MANUAL
تكاف	كافَى
تكث	كَثّ-ِ
تلعة	تَلْعَة
تليان	وَلِي-ِ
تناصف	ناصَف
التنانير	تَنُّور
تنبوك	نَبا
التنعيم	تَنْعِيم
التنور	تَنُّور
تنوف	ناف
تنوق	تَنَوَّق
تنونية	نَوَّن
تنوهة	نَوَّه
تنهاة	نَهَى-ِ
تنيس	تِنِس
التوائم	تَوْأَم
توبن	تَوَّب
توج	تَوَّج
توز	وَزّ
توما	تُوما
توم	تُوم
توي	تَوّ
تهامة	تِهامَة
تيراب	تَيْراب
التيس	تَيْس
تيل	تَيَّل
تيماء	تَيْماء
تيمك	تَيَّم
ثاءة	ثاء
ثاب	ثاب
الثأي	ثَأَى
ثبر	ثَبَر
ثبرة	ثَبَر
الثدي	ثَدْي
ثرا	ثَرّ
الثرثار	ثَرْثار
الثريا	ثُرَيّا
ثريد	ثَرِيد
ثعال	ثُعال
الثعلبية	ثَعْلَبِيّ
الثغور	ثَغْر
ثقبان	ثُقْب
ثكن	ثُكْنَة
ثلا	ثَلّ
الثلاثاء	ثُلاثاء
ثلاث	ثَلاث
الثمامة	ثُمام
ثمانين	ثَمانُون
ثمانية	ثَمانِي
ثمر	ثَمَر
الثمينة	ثَمِين
الثومة	ثُوم
ثيتل	ثَيْتَل
الجابري	جابِرِيّ
جادوا	جاد
جادية	جادّ
الجار	جار
جارف	جارِف
جازان	جازان
جاس	جاس
جاسم	جاسِم
جاسك	جاس
الجالية	جالِيَة
الجامدة	جامِد
الجامع	جامِع
الجامعين	جامِع
الجاهلي	جاهِلِيّ
جبار	جَبّار
الجبال	جَبَل
الجباية	جِبايَة
الجب	جُبّ
جبلان	جَبَل
الجبل	جَبَل
جبل	جَبَل
الجبة	جُبَّة
الجبيل	جُبَيْل
جبيل	جُبَيْل
الجبيل	جُبَيْل
جبيل	جُبَيْل
الجبيل	جُبَيْل
جحشية	جَحْش
جحور	جُحْر
الجداجد	جُدْجُد
الجدار	جِدار
الجدان	جَدّ
جدن	جاد
جديد	جَدِيد
الجديد	جَدِيد
جديد	جَدِيد
الجديدة	جَدِيد
جذاء	جَذْوَة
جذمان	جِذْم
جراد	جَراد
الجرادة	جَراد
الجرارة	جَرّار
جرام	جرام
جراميز	جَرامِز
جوارة	جِوار
الجرباء	أَجْرَب
الجربتان	جَرِب
جرجير	جِرْجِير
الجر	جَرّ
الجرعة	جُرْعَة
جرود	جَرِد
جريب	جَرِيب
الجريب	جَرِيب
جرير	جَرِير
الجريرة	جَرِيرَة
جرين	جَرَى-ِ
جزاز	جَزّاز
جزء	جُزْء
الجزائر	جَزائِر
جز	جَزّ
الجزيرة	جَزِيرَة
الجسر	جِسْر
الجسرة	جَسْرَة
جسرين	جِسْر
جش	جَشّ
جعران	جِعْران
الجعفري	جَعْفَرِيّ
الجفرتان	جُفْرَة
الجفرة	جُفْرَة
جفن	جَفْن
جلال	جَلال
الجلاميد	جُلْمُود
جلس	جَلَس-ِ
جلق	جِلِّق
جلود	جَلُود
جليانة	جَلَيان
الجليل	جَلِيل
الجماجم	جُمْجُمَة
جماجم	جُمْجُمَة
الجماح	جِماح
جمار	جُمّار
جماهير	جُمْهُور
الجمد	جَمْد
الجمرة	جَمْر
الجمن	أَلْجَم
الجمهور	جُمْهُور
جميل	جَمِيل
جناب	جَناب
الجناب	جَناب
الجنادل	جَنْدَل
جنان	جَنَّة
الجند	جُنْد
جنزة	جَنَّز
الجنوب	جَنُوب
الجنينة	جُنَيْنَة
الجواء	جَوّ
جوادة	جَواد
الجوار	جِوار
الجوانب	جانِب
جوب	جَوْب
جوخا	جُوخ
جودة	جَوْدَة
جورتان	جُورَة
جوزان	جَوْز
الجوز	جَوْز
جوسقان	جَوْسَق
الجوسق	جَوْسَق
الجوفاء	أَجْوَف
جولى	جُولِي
جونة	جُون
جونية	جُونِيَة
الجو	جَوّ
جويك	جَوِّيّ
جوين	جَوِي-َ
جهار	جِهار
جهور	جَهْوَر
جياد	جَيِّد
الجيار	جَيّار
جيار	جَيّار
جيدة	جَيِّد
جيران	جار
الجيزة	MANUAL
الجيش	جَيْش
الجيفة	جِيفَة
جيلان	جِيل
الجيل	جِيل
جيلة	جِيل
جينين	جِين
جيهان	جِيهان
جي	جِي
حاج	حاجّ
حاسم	حاسِم
الحاضر	حاضِر
حاطب	حاطِب
الحاطمة	حاطِم
حافر	حافِر
الحاكة	حائِك
الحال	حال
حاني	حان
الحامضة	حامِض
الحائر	حائِر
الحائط	حائِط
حائل	حائِل
الحباحب	حُباحِب
حبال	حَبْل
حبسان	حِبْس
حبش	حَبَش
حبوتن	حَبا
حبيب	حَبِيب
حبيس	حَبِيس
الحتات	حُتات
حجاج	حاجّ
الحجاز	MANUAL
حجيان	حَجِيّ
حداب	حَدَب
الحدادة	حِدادَة
الحدباء	أَحْدَب
الحدث	حَدَث
حدثة	حَدَث
حدد	حَدَّد
حدورة	حَدُور
الحديبية	حُدَيْبِيَّة
الحديثة	حَدِيث
الحديقة	حَدِيقَة
حراء	حِراء
حرام	حَرام
الحرامية	حَرامِيّ
حرب	حَرْب
الحربية	حَرْبِيّ
حرس	حَرَس
حرستا	حَرَس
حرشان	حَرِش
الحرقة	حُرْقَة
حرنة	حار
الحريرة	حُرَيْرَة
حريز	حَرِيز
حريم	حَرِيم
الحريم	حَرِيم
حزاز	حَزاز
الحز	حَزّ
حزورة	حَزُّورَة
حزة	حَزّ
الحساء	حَساء
حسان	حَسَن
الحسبة	حَسَب
حسمى	حَسْم
الحسنان	حَسَن
الحسيان	حِسِّيّ
الحشا	حَشاً
الحصان	حِصان
حصان	حِصان
الحص	حُصّ
الحصيدات	حَصِيد
الحصيد	حَصِيد
حصير	حَصِير
حضارم	حَضْرَمِيّ
حضارة	حَضارَة
الحضر	حَضَر
حضرموت	MANUAL
حضور	حُضُور
حضوة	حَضّ
الحطيم	حَطِيم
حطين	حِطِّين
الحظائر	حَظِيرَة
حظيان	حَظِيّ
الحظيرة	حَظِيرَة
حفار	حَفّار
حفاف	حِفاف
الحفائر	حَفِيرَة
الحفرة	حُفْرَة
حفيتن	حَفِي-َ
حفير	حَفِير
الحفير	حَفِير
حفير	حَفِير
الحفير	حَفِير
حقاء	حَقْو
الحقاب	حُقْب
حقل	حَقْل
الحقل	حَقْل
حقل	حَقْل
الحقو	حَقْو
الحقيبة	حَقِيبَة
الحكرة	حُكْرَة
حلال	حَلال
الحلال	حَلال
حلال	حَلال
الحلاوة	حَلاوَة
الحلبة	حَلْبَة
حلحل	حَلْحَل
حلحول	حَلْحُول
الحلمتان	حَلَم
الحليفات	حَلِيف
الحليف	حَلِيف
الحليفة	حَلِيف
الحليقة	حَلِيق
الحليل	حَلِيل
حليمات	حَلِيم
حليمة	حَلِيم
الحما	حَم
حماتا	حَماة
الحماتان	حَماة
حماس	حَماس
حماط	حَماط
حمال	حَمّال
الحمائر	حِمارَة
الحمائم	حَمام
حمدان	حَمْدان
الحمراء	أَحْمَر
حمير	حِمار
الحميمة	حَمِيم
الحناجر	حَنْجَر
حناك	حان-ِ
الحنان	حَنان
الحنانة	حَنانَة
حنبل	حَنْبَل
الحنبلي	حَنْبَلِيّ
حنجر	حَنْجَر
حنش	حَنَش
حنظلة	حَنْظَل
الحنفاء	حَنِيف
حنيف	حَنِيف
حنين	حَنِين
حواء	حَوّاء
حوارين	حِوار
الحوامض	حامِض
حوان	حَوانِي
حوايا	حَوِيَّة
حواية	حَوايَة
حوراء	أَحْوَر
الحوراء	أَحْوَر
حوران	MANUAL
الحوز	حَوْز
حوصاء	حَوَص
الحوض	حَوْض
حوضى	حَوْض
حوط	حَوَّط
الحوف	حَوْف
حوق	حَوَّق
حوي	حَوَى-ِ
حياء	حَياء
حيان	حَيّ
الحير	حَيْر
الحيرة	حَيْرَة
حيزان	حَيِّز
الحيز	حَيِّز
حيض	حَيْض
الحيق	حَيْق
الخابور	MANUAL
خاربان	خارِب
خاست	خاس-ِ
خاص	خاصّ
الخافقين	خافِق
الخافقان	خافِق
الخالدية	خالِدِيَّة
خالد	خالِد
الخال	خال
خامر	خامَر
الخانقان	خانِق
الخانقة	خانِق
خانقين	خانِق
خان	خان
خبان	خَبّ
الخب	خَبّ
خبرين	خَبَر
خبنك	خاب-ِ
خبيب	خَبِيب
الخبيرات	خَبِير
الخبيص	خَبِيص
خبي	خَبّ
الختل	خَتْل
خدا	خَدّ
الخدود	خَدّ
خراب	خَراب
خراسان	MANUAL
خراص	خَرّاص
الخرانق	خِرْنِق
خرتنك	خَرَت
الخرج	خَرْج
الخرصان	خِرْص
الخرقاء	أَخْرَق
خركن	خَرّ
خرنق	خِرْنِق
خروب	خَرُّوب
الخروبة	خَرُّوبَة
خرور	خُرُور
الخريجة	خِرِّيج
خرير	خَرِير
خزام	خِزام
خزر	خَزَر
الخزف	خَزَف
خزوزى	خُزُوز
خشا	خَشّ
خشاش	خِشاش
الخشبي	خَشَبِيّ
الخشبية	خَشَبِيّ
خش	خَشّ
خشك	خَشّ
الخصوص	خُصُوص
الخصيتان	خُصْيَة
خضاب	خِضاب
الخضارم	خِضْرِم
خضراء	أَخْضَر
خضرمة	خِضْرِم
خضلات	خَضِل
خضمان	خِضَمّ
الخط	خَطّ
الخطط	خُطَّة
خطم	خَطْم
خطمة	خَطْم
خلاطا	خَلّاط
خلاط	خَلّاط
الخلائق	خَلِيق
خلخال	خَلْخال
الخل	خَلّ
خليت	خَلَّى
الخليج	خَلِيج
خليص	خَلِيص
خليفة	خَلِيفَة
خليقة	خَلِيق
الخليقة	خَلِيق
خليقى	خَلِيق
الخليل	خَلِيل
خناثا	خُنْثَى
خناس	خَنّاس
خناصرة	خِنْصِر
الخنافس	خُنْفُس
خنجرة	خَنْجَر
الخندق	خَنْدَق
خنزب	خَنْزَب
خنزير	خِنْزِير
خنفر	خَنْفَر
الخنفس	خُنْفُس
خنفس	خُنْفُس
الخنق	خَنْق
خوارج	خَوارِج
خوزستان	MANUAL
خوست	خُوست
خونا	خَوَّن
خونت	خَوَّن
الخوة	خُوَّة
خيبر	خَيْبَر
خيرين	خَيِّر
الخيس	خَيْس
خيس	خَيْس
خيش	خَيْش
الخيمات	خَيْمَة
الخيمة	خَيْمَة
داءة	داء
داجون	داجِي
داسر	داسِر
الدالية	دالِيَة
دامغان	دامِغ
دانا	دان-ِ
دانية	دانِي
داور	داوَر
دباب	دَبّاب
الدبر	دُبْر
دبل	دِبْلَة
دبورية	دَبُّور
دبوسية	دَبُّوس
دحل	دَحَل
دحوض	دُحُوض
الدخول	دُخُول
الدراج	دُرّاج
الدرب	دَرْب
دردشت	دَرْدَش
درق	دَرَق
الدسكرة	دَسْكَرَة
دسمان	دَسِم
الدشت	دَشْت
دردشت	دَرْدَش
دشنتة	دَشَّن
دشنى	دَشّ
الدعجاء	أَدْعَج
دفاق	دَفّاق
الدفن	دَفْن
الدكان	دُكّان
دلاية	دَلّايَة
دمدم	دَمْدَم
دمشق	MANUAL
دمما	دَمَّم
دمنهور	دَمَنْهُور
دميرة	دَمِيرَة
دمياط	MANUAL
الدنان	دِنان
دندنة	دَنْدَن
دنقلة	دُنْقُلَه
دن	دان-ِ
الدنان	دِنان
دورق	دَوْرَق
الدورق	دَوْرَق
دورقة	دَوْرَق
دولاب	دُولاب
دولان	دُولان
دومان	دُومان
دهر	دَهْر
دهشور	دَهْشُور
دهقان	دِهْقان
دهك	دَهَك-َ
دهلك	دَهْلَك
الدهناء	دَهْناء
الديدان	دُود
ديشان	دِيشان
ديماس	دِيماس
دينار	دِينار
ديوان	دِيوان
ذباب	ذُباب
ذبيان	ذُبْيان
الذحل	ذَحْل
ذخيرة	ذَخِيرَة
ذراح	ذُرّاح
ذراعان	ذِراع
ذربان	ذَرِب
الذربة	ذَرِب
ذرو	ذَرْو
ذمار	ذِمار
ذنبان	ذَنَب
الذنوب	ذَنْب
الذهاب	ذَهاب
ذياد	ذِياد
الذئب	ذِئْب
الذئبين	ذِئْب
رابغ	رابِغ
رابغة	رابِغ
راجل	راجِل
الراحة	راحَة
راخ	راخِي
راسب	راسِب
راسك	رَأْس
راسة	رَأْس
راشت	راش
راعب	راعِب
الرافدان	رافِد
رامح	رامِح
رأم	رَأَم-َ
راموسة	رامُوس
رامي	رامِي
رانني	ران-ِ
راوند	راوَنْد
راوية	راوِي
رائع	رائِع
الراية	رايَة
الربا	رِبا
رباب	رَباب
رباح	رُبّاح
ربب	رَبَّب
الربض	رَبَض
الربعة	رَبْعَة
الربو	رَبْو
الربيع	رَبِيع
رجام	رُجْمَة
رجيع	رَجِيع
رجينة	رَجِي-َ
رحاب	رِحاب
الرحاب	رِحاب
الرحابة	رَحابَة
رحايا	رَحّاي
الرحيب	رَحِيب
الرحيل	رَحِيل
رحية	رَحَى
رخام	رُخام
الرخم	رَخَم
رخيم	رَخِيم
الرخيمة	رَخِيم
الرد	رَدّ
ردفان	رِدْف
الرده	رَدَّة
الرزق	رِزْق
رزيق	رَزِيق
رستاق	رُسْتاق
الرشاء	رِشاء
رشيد	رَشِيد
رصاف	رَصّاف
رضاء	رِضاء
الرضاب	رُضاب
الرضم	رَضْم
رعان	رَعْن
رعين	رَعَى-َ
رفح	رَفَح
رفرف	رَفْرَف
الرفيق	رَفِيق
رقادة	رُقاد
الرقبتان	رَقَبَة
الرقراق	رَقْراق
الرقعة	رُقْعَة
الرقة	رِقَّة
الرقيق	رَقِيق
الرقيم	رَقِيم
ركك	رَكّ
الرماحة	رَمّاح
رمادة	رَماد
رمان	رُمّان
الرمث	رَمَث
الرمص	رَمَص
الرمل	رَمْل
الرملة	MANUAL
رميتان	رَمْيَة
الرميثة	رُمَيْثَة
رميلة	رُمَيْلَة
الرميلة	رُمَيْلَة
رنان	رَنّان
رندة	MANUAL
الرواح	رَواح
روثة	رَوْث
الروج	رُوج
رودس	رُودُس
روضتان	رَوْضَة
مليص	مَلِيص
رولان	رُولان
رومان	رُومان
الروماني	رُومانِيّ
رؤيا	رُؤَى
رويان	رَوِيّ
رؤيتان	رُؤْيَة
رؤية	رُؤْيَة
رهاط	رَهْط
رهنان	رَهْن
رهوى	رَهْو
ريدة	رَوْد
ريعان	رَيْعان
ريو	رِيُو
الري	رَيّ
رابات	رابَّة
زار	زار
زام	زام
الزاوية	زاوِيَة
الزباء	أَزَبّ
زبانى	زُبانَى
زبنة	زَبُون
زبيد	زُبَيْد
الزبير	زُبَيْر
زبية	زُبْيَة
الزحف	زَحْف
زخمان	زَخِم
زخة	زَخَّة
زرافات	زَرافَة
الزرائب	زَرِيبَة
زرد	زَرَد
زردنا	زَرَد
زرنيخ	زِرْنِيخ
زرود	زَرَد
زريق	زُرَيْق
الزعازع	زَعْزَعَة
زعر	زَعِر
زغر	زَغَر-َ
زلالة	زُلال
زلم	زَلَم
زمان	زَمان
زمزم	زَمْزَم
زم	زَمّ
زمهر	زَمْهَر
الزميل	زَمِيل
الزناء	زِناء
زناته	زانِي
زنانير	زُنّار
زنبق	زَنْبَق
زنج	زَنْج
زنيم	زَنِيم
زوراء	أَزْوَر
الزوراء	أَزْوَر
زولاه	زَوَّل
زها	زَها
الزهري	زُهَرِيّ
زهمان	زَهِم
زيتان	زَيْت
الزيت	زَيْت
الزيتون	زَيْتُون
الزيتونة	زَيْتُونَة
زيدان	زَيْدان
الساباط	ساباط
الساج	ساج
الساحل	ساحِل
الساعد	ساعِد
الساقة	ساقَة
سالوس	لاس
سامان	سامّ
سامراء	MANUAL
ساوين	ساوَى
ساو	ساو
الساهرة	ساهِر
السائبة	سائِب
سبأ	سَبَأ
سبا	سَبّ
سبارى	سِبار
السباع	سَبْع
سبال	سَبَلَة
سبج	سَبَج
سبرت	سَبَر
سبراة	سَبَر
سبرنى	سَبَر
سبن	ساب-ِ
سبوحة	سَبُوح
سبيبة	سَبِيب
الستاران	سِتار
الستارة	سِتارَة
ستيكن	سِتّ
سجا	سَجا
سجلين	سِجِلّ
سحام	سُحام
سحامة	سُحام
سخا	سَخا
سخال	سَخْلَة
سخام	سُخام
السخف	سَخْف
سدوم	سَدُوم
سدين	سَدَّى
سراء	سَرّاء
السرار	سَرار
سرخس	MANUAL
السرد	سَرْد
السرر	سُرَّة
سرف	سَرَف
سرقسطة	MANUAL
سرمد	سَرْمَد
سرنديب	سَرَنْدِيب
سرنة	سار-ِ
سروج	سَرْج
سرور	سُرُور
السرو	سَرْو
سرو	سَرْو
السرو	سَرْو
سرير	سَرِير
السرير	سَرِير
سريعة	سَرِيع
السطح	سَطْح
سطيف	سَطِيف
السعدان	سَعْدان
السعد	سَعْد
السعدية	سَعْدِيّ
السعديين	سَعْدِيّ
السعيدة	سَعِيد
سعير	سَعِير
سفان	سَفّان
السفح	سَفْح
السفوح	سَفْح
سفيان	سُفْيان
سفير	سَفِير
السفير	سَفِير
سفيرة	سَفِير
سقر	سَقَر
السقيفتان	سَقِيفَة
سقية	سَقْي
سكاء	أَسَكّ
سكاك	سَكّ
سكران	سَكْران
السكران	سَكْران
السكرة	سَكْرَة
سلاح	سِلاح
السلاسل	سِلْسِلَة
سلاطح	سُلاطِح
السلالم	سُلَّم
السلامى	سُلامَى
سلامان	سَلام
السلامة	سَلامَة
السلامية	سُلامَى
السلائل	سَلِيلَة
سلسل	سَلْسَل
السلفين	سِلْف
سلوى	سَلْوَى
سلوقية	سَلُوقِيّ
السليل	سَلِيل
السليلة	سَلِيلَة
السليم	سَلِيم
سليم	سَلِيم
سماءة	سَماء
سمادير	سُمْدُور
سماطة	سِماط
سمان	سَمّان
السماوة	سَماوَة
سمائم	سَمُوم
سمرقند	MANUAL
سمسم	سِمْسِم
سمعان	سِمْعان
سمندر	سَمَنْدَر
سمورة	سَمُّور
سميحة	سَمِيح
سميران	سَمِير
سمير	سَمِير
سمين	سَمَّى
سناء	سَناء
سناج	سِناج
سنام	سَنام
سنبلان	سُنْبُل
سنبان	أَبان
سنبوس	باس
سنبيل	أَبال
سنجان	جانَى
سنجبذ	جَبَذ-ِ
السنح	سُنْح
السنطة	سَنْطَة
السواء	سَواء
سواء	سَواء
السواد	سَواد
السواس	سائِس
سوان	سانِيَة
السوداء	أَسْوَد
السود	أَسْوَد
سوريان	سُورِيّ
السوس	سُوس
سوسية	سُوس
سوفة	سَوَّف
سولة	سَوَّل
السويداء	سُوَيْداء
سويس	سُوَيْس
السهب	سُهْب
سهبى	سُهْب
السهل	سَهْل
السهلين	سَهْل
السهلة	سَهْل
سهوان	سَهْوان
سهو	سَهْو
سهيل	سُهَيْل
سيار	سَيّار
سيارى	سَيّار
السيال	سَيّال
سيبان	أَبان
السيب	سِيب
سيج	سَيَّج
سيحاط	أَحاط
سيحون	وَحَى-ِ
السيدان	سَيِّد
السيد	سَيِّد
السيران	سَيْر
السيرين	سَيْر
سيكث	كَثّ-ِ
سينان	سِين
سيوط	وَطَّى
السين	سِين
السي	سِي
سيهى	وَهَى-ِ
سية	وَهَى-ِ
شاباي	شابّ
شاتان	شاة
شاحط	شاحِط
شار	شارِي
شارع	شارِع
شارك	شارَك
شاس	شاس
شاش	شاش
شاط	شاط-ِ
الشاغرة	شاغِر
شافيا	شافِي
شامات	شامَة
الشامات	شامَة
الشأم	شام
الشام	شام
شامة	شامَة
شاهي	شاهِي
الشبا	شَباً
شباعة	شَبْعان
شبام	شِبام
الشبعان	شَبْعان
الشبكة	شَبَكَة
شبلان	شِبْل
الشبيكة	شَبِيكَة
شتر	شَتَر-ِ
شجار	شِجار
شخاخ	شَخّ
شخب	شَخَب-َُ
شخصان	شَخْص
الشراء	شِراء
الشراشر	شَراشِر
الشراة	شارِي
الشربة	شَرْبَة
شرج	شَرَج
شرجة	شَرَج
الشرف	شَرَف
شرقيون	شَرْقِيّ
الشرقية	شَرْقِيّ
الشرقي	شَرْقِيّ
الشرقية	شَرْقِيّ
الشركة	شَرِكَة
شرورى	شَرّ
شروط	شَرْط
شروم	شَرْم
شريان	شِرْيان
شريط	شَرِيط
الشريف	شَرِيف
شريفة	شَرِيف
الشطآن	شاطِئ
شطنان	شَطْن
شظي	شَظِي-َ
الشعبتان	شُعْبَة
شعبين	شَعْب
شعوب	شَعْب
شعيبة	شَعِيب
الشعير	شَعِير
شغور	شُغُور
شفار	شَفْرَة
الشفع	شَفْع
الشفير	شَفِير
الشفيقة	شَفِيق
الشقائق	شَقِيقَة
الشقراء	أَشْقَر
شقوق	شَقّ
الشقوق	شَقّ
الشقيق	شَقِيق
الشقيقة	شَقِيقَة
شكستان	شَكِس
شكلان	شَكْل
شماء	أَشَمّ
شماليل	شُمْلُول
شمام	شَمّام
شمخ	شَمَخ-َ
الشمطاء	أَشْمَط
شمن	شام-ِ
شميسى	شُمَيْسِيّ
شميط	شُمَيْط
شميهن	شَمِّيّ
شنائك	شانِئ
شنط	شَنْطَة
شنودة	شِنُودَة
شوابة	شابَّة
شوا	شَوّا
الشوبك	شَوْبَك
الشوذر	شَوْذَر
شور	شَوَّر
الشوش	أَشْوَش
شوطان	شَوْط
شوط	شَوْط
شوطى	شَوْط
شهاق	شَهِيق
الشهبة	شَهَب
شهد	شَهِد-َ
الشهلاء	أَشْهَل
شهوان	شَهْوان
شيا	شَيّ
الشيبانية	شَيْبانِيّ
شيحان	شِيحان
الشيح	شِيح
شيخ	شَيْخ
شيخان	شَيْخ
الشيخة	شَيْخَة
شيراز	MANUAL
سيرجان	رَجّ
شير	شِير
شيرين	شيرين
الشيطان	شَيْطان
الشيقان	شَيِّق
الشيق	شَيِّق
شيلمان	شِيلْمان
شي	شَيّ
شيي	شَيّ
الصابر	صابِر
الصابوني	صابُونِيّ
صاحة	صاح-ِ
الصادر	صادِر
صارخة	صارِخ
صاري	صارِي
صاع	صاع
صاغرة	صاغِر
صاف	صافِي
الصافية	صافِي
صالحان	صالِح
صان	صان
صاهل	صاهِل
صباب	صَبّاب
صبيب	صَبِيب
صبيرة	صُبَّيْر
صحار	صَحارِي
الصخرة	صَخْر
صدار	صِدار
الصدارة	صَدارَة
صدد	صَدَد
الصراد	صُرّاد
صراد	صُرّاد
صرار	صَرّار
صراف	صَرّاف
الصرح	صَرْح
صرخ	صَرَخ
صرعينا	صَرْعِيّ
الصريد	صُرّاد
الصريف	صَرِيف
الصريمة	صَرِيمَة
الصعاب	صَعْب
صعادى	صَعّاد
الصعيد	صَعِيد
الصفا	صَفاً
صفار	صَفار
الصفراء	أَصْفَر
صف	صَفّ
الصفقة	صَفْقَة
صفوان	صَفْوان
الصفيحة	صَفِيحَة
الصفيين	صَفِيّ
صقر	صَقْر
صقلية	MANUAL
صكا	صَكّ
الصلح	صُلْح
صلصل	صَلْصَل
الصلصلة	صَلْصَلَة
الصلعاء	أَصْلَع
الصليب	صَلِيب
صماخ	صِماخ
الصماخ	صِماخ
صماد	صِماد
الصمان	أَصَمّ
الصمتان	صَمِت
الصنبور	صُنْبُور
صندل	صَنْدَل
صنعاء	MANUAL
الصنمان	صَنَم
صنم	صَنَم
الصنين	صَنّ
صواعق	صاعِقَة
صهباء	أَصْهَب
الصهوة	صَهْوَة
صهيد	صَهِيد
صهيون	MANUAL
الصياحة	صَيّاح
صيداء	صَيْداء
صيد	صَيْد
صير	صَيَّر
صيرة	صَيَّر
الصين	صِين
ضاجع	ضاجَع
ضاحك	ضاحِك
الضاحي	ضاحِي
ضأن	ضَأْن
الضائن	ضائِن
ضباب	ضَباب
الضباع	ضَبْع
ضباعة	ضَبْع
ضبح	ضَبَح-َ
الضبر	ضَبْر
ضبع	ضَبْع
الضبع	ضَبْع
الضجاج	ضَجّاج
الضجوع	ضُجُوع
ضحا	ضَحا
الضحاكة	ضَحّاك
ضدا	ضِدّ
ضديان	ضِدِّيّ
ضرغام	ضَرْغَم
ضريبة	ضَرِيبَة
ضريحة	ضَرِيح
ضفيرة	ضَفِيرَة
الضلعان	ضِلْع
الضمد	ضَمْد
ضمرة	ضُمْر
ضمير	ضَمِير
ضميم	ضَمِيم
ضوت	ضَوَى-ِ
الضيقة	ضَيِّق
ضيم	ضَيْم
الطاحونة	طاحُونَة
طارف	طارِف
طارق	طارِق
طار	طار-ِ
طاسى	طاس
الطاق	طاق
طالقة	طالِق
طاووس	طاؤُوس
الطائر	طائِر
الطائف	طائِف
طبب	طَبَّب
طبرك	طَبَر
طرابلس	MANUAL
طراز	طِراز
طراق	طارِق
طرائف	طَرِيفَة
طررة	طُرَّة
طرطر	طَرْطَر
طرطوس	MANUAL
الطرفاء	طَرْفاء
طرون	طَرُو
طريف	طَرِيف
طغامى	طَغام
طلا	طَلّ
طلاح	طَلاح
طلبان	طَلَب
طل	طَلّ
طلوح	طَلْح
طليطلة	MANUAL
طمار	طُمار
طمين	طَمَى-ِ
طمية	طَمْي
طنت	طَنّ
طنجة	طَنْجَة
الطواحين	طاحُونَة
طواويس	طاؤُوس
الطوب	طُوب
طود	طَوْد
الطور	طَوْر
طوران#	طَوْر
والطور	طَوْر
طوران	طَوْر
طورين	طَوْر
طوس	طَوَّس
طوسن	طَوَّس
الطويلة	طَوِيل
الطوي	طَوَى
طهران	طَهْران
طيفور	طَيْفُور
طيلسان	طَيْلَسان
الطين	طِين
الطينة	طِينَة
الظاهر	ظاهِر
الظباء	ظَبْي
ظبيان	ظَبْي
ظران	ظِرّان
ظفار	ظُفار
ظلال	ظِلّ
ظليم	ظَلِيم
الظهار	ظِهار
ظهور	ظُهُور
عابد	عابِد
عابدين	عابِد
عاج	عاج
عاذ	عاذ
عارم	عارِم
عارمة	عارِم
عازب	عازِب
عازف	عازِف
عاسم	عاسِم
عاص	عاصِي
عاصم	عاصِم
العاصمية	عاصِمِيّ
العاصي	عاصِي
عاقل	عاقِل
عالج	عالَج
العاليات	عالِي
عامر	عامِر
العامرية	عامِرِيَّة
عاند	عانَد
عانق	عانَق
عاهن	عاهِن
عائد	عائِد
عائم	عائِم
عبادان	عَبادان
العباسية	عَبّاسِيّ
عبدان	عَبْد
العبد	عَبْد
العبرات	عَبْرَة
عبقر	عَبْقَر
عبلة	عَبْل
عبود	عَبُّود
عبوس	عُبُوس
عبيدان	عُبَيْدان
عتك	عَتَك-ِ
العتيد	عَتِيد
عتيد	عَتِيد
العتيق	عَتِيق
العتيقة	عَتِيق
عثمان	عُثْمان
العثير	عِثْيَر
عثير	عِثْيَر
عجرم	عَجْرَم
عجلان	عَجْلان
العجلة	عَجَلَة
عجوز	عَجُوز
عجيب	عَجِيب
عدولى	عُدُول
العدوية	عَدَوِيَّة
عديد	عَدِيد
عدينة	عَدَّى
عذار	عِذار
عذاة	عَذاة
عذراء	عَذْراء
عذق	عِذْق
العذي	عَذِيّ
عرابة	عَرّاب
العرابة	عَرّاب
عراجين	عُرْجُون
العرادة	عَرّادَة
عرار	عَرار
العراق	MANUAL
عراقيب	عُرْقُوب
العرائس	عَرُوس
عربات	عَرَبَة
العرجاء	أَعْرَج
العرج	عَرَج
العرجة	عَرَجَة
العرش	عَرْش
عرشان	عَرْش
عرعر	عَرْعَر
عرفات	عَرَفات
عرفان	عِرْفان
العرف	عُرْف
العرفة	عَرَفَة
العرقوب	عُرْقُوب
العرناس	عِرْناس
العروس	عَرُوس
العروسين	عَرُوس
العروش	عَرْش
العروق	عِرْق
عريان	عُرْيان
عريش	عَرِيش
عريض	عَرِيض
عريق	عَرِيق
عريقة	عَرِيق
عريقية	عَرِيق
العرين	عَرِين
العزى	عُزَّى
العزف	عَزْف
العزيزية	عَزِيزِيّ
العزيف	عَزِيف
عساقيل	عُسْقُول
عسجد	عَسْجَد
العسجدية	عَسْجَدِيّ
عسعس	عَسْعَس
عسلج	عُسْلُج
عسيب	عَسِيب
العسير	عَسِير
العشائر	عَشِيرَة
العشتان	عُشَّة
عشرون	عِشْرُون
العش	عُشّ
عشوراء	عاشُوراء
العشة	عُشَّة
العشير	عَشِير
العصا	عَصاً
العصيب	عَصِيب
عضدان	عَضُد
عطالة	عَطالَة
العظاءة	عِظاءَة
عفار	عُفار
عفراء	أَعْفَر
عفرى	عَفَر
عفرين	عِفْرِين
العفيف	عَفِيف
عقنة	عاق
العقور	عَقُور
العقيرة	عَقِيرَة
العقيق	عَقِيق
عكاظ	عُكاظ
عكبرا	عِكْبِر
عك	عَكّ
العلا	عَلا
العلاء	عَلاء
العلاتان	عَلاة
العلاة	عَلاة
علاف	عَلَف
العلاقي	عَلاقِيّ
علان	عَلّان
العلاية	عَلايَة
علمان	عَلَم
العليبة	عُلَيْبَة
العماد	عِماد
العمارية	عَمّارِيَّة
عماق	عَمِيق
عماية	عَمايَة
عمران	عُمْران
العمرانية	عُمْرانِيّ
عمران	عُمْران
عمرو	عَمْرو
أسال	أَسال
العمرية	عُمْرِيّ
العم	عَمّ
عم	عَمّ
العمير	عُمَيْر
العميم	عَمِيم
العناب	عُنّاب
العناج	عِناج
عناصر	عُنْصُر
عنبة	عِنَب
عندل	عَنْدَل
عنز	عَنْز
عنس	عَنَس-ِ
عنصل	عُنْصُل
العنصلان	عُنْصُل
عنقاء	عَنْقاء
عنك	عَن
العنك	لَعَن-َ
عنيزة	عُنَيْزَة
عنيزتين	عُنَيْزَة
عوار	عَوار
عوارض	عارِض
عوارة	عَوار
العواصم	عاصِمَة
العواقر	عاقِر
عوال	عالِيَة
العوالي	عالِيَة
عوانة	عَوان
العوانة	عَوان
العوجاء	أَعْوَج
العوراء	أَعْوَر
العوسج	عَوْسَج
عوسجة	عَوْسَج
عوف	عَوْف
عويص	عَوِيص
عوي	عَوَى-ِ
العيرة	عِيرَة
عينان	عَيْن
العين	عَيْن
عينين	عَيْن
غابر	غابِر
غابة	غابَة
الغابة	غابَة
غادة	غادَة
الغار	غار
غاف	غافِي
غامية	غامّ
غانة	غانَة
الغائط	غائِط
غباء	غَباء
غبب	غَبَب
الغبراء	أَغْبَر
غبية	غَبِيّ
غدان	غِدان
غدير	غَدِير
غراب	غُراب
الغرابة	غَرابَة
الغراف	غَرّاف
الغرس	غَرْس
غرش	غِرْش
غرمى	غُرْم
غرناطة	MANUAL
غروب	غُرُوب
غرور	غُرُور
الغرو	غَرْو
الغريض	غَرِيض
الغريق	غَرِيق
غزة	MANUAL
غزية	غَزِّيّ
غسان	غَسّان
غشاوة	غِشاوَة
الغصن	غُصْن
الغضاب	غَضْبان
الغضي	غَضَى
الغفارتين	غِفارَة
غلائل	غِلالَة
غلغل	غَلْغَل
غما	غَمّ
الغمار	غَمْرَة
الغمر	غَمْر
الغموض	غُمُوض
الغميس	غَمِيس
غميس	غَمِيس
الغميسة	غَمِيس
الغور	غَوْر
غوره	غَوْر
الغوطة	MANUAL
غول	غُول
الغيض	غَيْض
الغيضة	غَيْضَة
الغيلة	غِيلَة
الغيلم	غَيْلَم
غيناء	أَغْيَن
الفاخرة	فاخِر
فاران	فارّ
فاشون	شَوَّن
فب	ب
الفتات	فُتات
فتاخ	فَتْخَة
الفجيرة	فُجَيْرَة
الفحص	فَحْص
فدك	دَكّ
فديك	دِيك
الفرات	فُرات
الفراخ	فِراخ
الفراديس	فِرْدَوْس
فراقد	راقِد
فربيا	رَبَّى
فرتاج	رِتاج
فرجيا	رَجِي-َ
الفرد	فَرْد
فردد	رَدَّد
الفرد	فَرْد
فردوس	فِرْدَوْس
الفردة	فَرْد
الفردين	فَرْد
فرزين	رَزِين
الفرضة	فُرْضَة
الفرع	فَرْع
فرغان	فَرِغ
الفرغ	فَرِغ
فرقب	رَقَب
الفرك	فَرْك
فروات	فَرْوَة
الفروان	فَرّاء
الفرود	فَرْد
الفروع	فَرْع
فسا	فَسا
فساران	سارّ
فستجان	جانَى
الفسطاط	فُسْطاط
فسنجان	جانَى
الفص	فَصّ
الفضاء	فَضاء
الفضل	فَضْل
فطرس	طِرْس
فطيمة	فَطِيم
الفغوة	فَغْوَة
الفقء	فَقْء
الفقار	فَقار
الفقير	فَقِير
الفقي	فَقِيّ
فلاج	لاجّ
فلتوم	تُوم
الفلس	فِلْس
فلسطين	MANUAL
فلطاح	فِلْطاح
فلفلان	فُلان
الفلق	فَلْق
الفلوجة	فَلُّوجَة
فليجة	جَهِي-َ
فنا	فَنّ
فناخره	نَخَر
فنجة	جَهِي-َ
الفندق	فُنْدُق
فنين	فَنِي-َ
الفوارس	فارِس
الفوارة	فَوّارَة
فوران	فَوَران
الفوعة	فَوْعَة
الفولة	فُول
فوة	فُوه
فياض	فَيّاض
فيحة	وَحَى-ِ
فيروزان	راز
الفيض	فَيْض
فيف	وَفَى-ِ
فيق	وَقَى-ِ
الفيوم	فَيُّوم
قابس	قابِس
القابل	قابِل
القابلة	قابِل
القاحة	قاحَة
قادس	قادِس
القادسية	قادِسِيَّة
قادم	قادِم
قاصرة	قاصِر
قاصرين	قاصِر
القاع	قاع
القاعة	قاعَة
قاف	قاف
القامة	قامَة
القانون	قانُون
القاهرة	قاهِرَة
القائم	قائِم
القباب	قُبَّة
قبريان	قَبْرِيّ
قبرين	قَبْر
القبيبات	قُبَيْبَة
قبيلا	قَبِيل
قتات	قَتّات
قتاد	قَتاد
قتبان	قَتَب
القحمة	قُحْمَة
قداس	قُدّاس
القدامي	قَدِيم
قديد	قَدِيد
قديس	قِدِّيس
القديمة	قَدِيم
القذاف	قَذّاف
قراح	قَراح
قرار	قَرار
قراص	قُرّاص
القرافة	قَرافَة
قراقر	قَرْقَرَة
قراقرة	قَرْقَرَة
قراقري	قَرْقَرَة
قران	قِران
القرائن	قَرِينَة
قرتوه	قَرَت-ِ
قرحان	قَرِح
قرد	قِرْد
قردة	قِرْد
قردا	قِرْد
القردية	قِرْدِيّ
القرشية	قُرَشِيّ
قرطاجنة	قَرْطاجَنَّة
قرطبة	MANUAL
قرطسا	قَرْطَس
قرظ	قَرَّظ
القرعاء	أَقْرَع
قرقر	قَرْقَر
قرقنة	قَرَق
قرمان	قَرْم
قرمد	قَرْمَد
القرنتان	قُرْنَة
القرنين	قَرْن
قرنين	قَرْن
القروط	قُرْط
القرو	قَرْو
قرير	قَرِير
القريش	قُرَيْش
القريشية	قُرَيْشِيّ
القرين	قَرِين
القرينتان	قَرِينَة
القرينة	قَرِينَة
القرينين	قَرِين
قزقز	قَزْقَز
قزوينك	قَزْوِين
قزوين	MANUAL
القزية	قَزِّيّ
قساء	قِسِّيس
قساس	قَسّاس
القس	قَسّ
القسطل	قَسْطَل
قسطل	قَسْطَل
قسطلة	قَسْطَل
قسطيلية	قَسْطِيلِيّ
قسطون	قِسْط
قسنطينية	قُسَنْطِنِيّ
قسيان	قَسِيّ
قشتالة	قَشْتالَة
القشر	قِشْر
القشيب	قَشِيب
القصا	قَصَى
القصبات	قَصَب
قصران	قَصْر
القصران	قَصْر
القصيبة	قُصَيْبَة
القصير	قَصِير
القصيم	قَصِيم
قصيمة	قَصِيم
قضة	قَضّ
القضيب	قَضِيب
قطاتان	قَطاً
القطائع	قَطِيعَة
القطب	قُطْب
القطعاء	أَقْطَع
القطم	قَطْم
القطيف	قَطِيف
القطيفة	قَطِيفَة
القعاقع	قَعْقَعَة
القعر	قَعْر
القفص	قَفَص
قفصة	قَفَص
القف	لَقِف-َ
قفير	قَفِير
القفير	قَفِير
قلاب	قَلّاب
القلادة	قِلادَة
قلبين	قَلْب
القلتان	قُلَّة
القلتين	قُلَّة
القلعة	قَلْعَة
قلنسوة	قَلَنْسُوَة
قلنة	قال
قلوس	قَلْس
قلوسنا	قَلْس
قمار	قِمار
قمامة	قُمامَة
قملان	قَمِل
قم	قَمّ
القنافذ	قُنْفُذ
القناية	قَنايَة
قندهار	قَنْدَهار
قنصل	قُنْصُل
قنوان	قُنْو
قنوى	قُنْو
قنينات	قِنِّينَة
القوادس	قادِس
القوادم	قادِمَة
قوارير	قارُورَة
القوائم	قائِمَة
قورى	قارَة
قوسان	قَوْس
قوسى	قَوْس
قومس	قَوْمَس
قومسة	قَوْمَس
قون	قُونَة
قونية	قُونِيَة
قويق	قُوَيْق
قها	قَها
القهر	قَهْر
قيا	قِياء
قياض	قِياض
القيروان	MANUAL
قيظ	قَيْظ
قيقان	قاق
قين	قَيْن
قينان	قِينان
كاخ	أَخ
كارزين	كارِز
كازه	أَزّ
كاسكان	إِسْكان
كافر	كافِر
الكاف	كاف
كاكس	إِكْس
كاوار	أُوار
كاهون	أَهْوَن
كبكب	كَبْكَب
كبيب	بِيانُو
الكبيبة	كُبَيْبَة
كبيس	كَبِيس
كتانة	كَتّان
كتمان	كِتْمان
كتمى	كَتْم
كتيب	كُتَيِّب
كثوة	ثُوَّة
كثه	كَثّ
الكثيب	كَثِيب
كحلان	كَحِل
الكحيل	كَحِيل
كداء	داء
كدادة	دادَة
كدد	كَدَّد
كراثا	كَرّاث
الكراث	كَرّاث
كراجك	كَراج
كربلاء	MANUAL
كرتم	رَتَم-َ
الكرج	كُرْج
كر	كَرّ
الكر	كَرّ
كرسي	كُرْسِيّ
الكرش	كِرْش
كركر	كَرْكَر
كركور	كَرْكُور
كركين	رَكِين
كرمان	رُمّان
كرملين	كرِمْلِين
كرنبة	كُرُنْب
كرنة	رَنَّة
الكرير	كَرِير
كزمان	زَمان
كسادن	سادِن
كستانة	ساتان
الكسر	كَسْر
الكسوة	كِسْوَة
كشب	شَبّ
كش	كَشّ-ِ
كشمر	شَمَر
كشميهن	شَمِّيّ
الكعبة	كَعْبَة
الكفتة	كُفْتَة
كفجين	فَجّ
كفركنا	فَرْك
الكفين	كَفّ
كلاف	كَلّاف
كلالى	كَلال
كلامين	لام
كلز	لَزّ
الكليبين	كَلِيب
كليوان	لِيوان
كمام	كِمام
كمزار	مَزار
كمران	مِران
كمسان	مِسَنّ
كمم	كَمَّم
كمينان	كَمِين
كناثر	ناثِر
كنبوت	نَبُّوت
كندوان	نَدْوان
كنطي	نَطّ
كنعان	كَنْعان
كنن	كَنّ-ِ
كنهل	نَهْل
كنن	كَنّ-ِ
الكنيسة	كَنِيسَة
كواكب	كَوْكَب
كوبان	كوان
كوبيان	كُوبِيّ
كوثابه	وَثّاب
كوزا	كُوز
كوعة	كُوع
كوفد	وَفْد
الكوفة	MANUAL
الكوكبية	كَوْكَبِيّ
كولان	كُولان
كول	كُول
كومين	كَوْم
الكهف	كَهْف
كهلان	كَهْل
كهيلة	هَيْل
كيران	كِير
كير	كِير
لاحج	حَجّ
اللاذقية	لاذِقِيَّة
لارجان	أَرِج
لاز	أَزّ
اللؤلؤة	لُؤْلُؤ
لامش	مَشّ
لباب	باب
لباح	باح
لتنكشة	نَكَش-َِ
لجاة	جاه
لجنياته	جَنْي
اللحيان	لَحْي
لرت	رُتّ
لسنونة	سَنا
اللسان	لِسان
لشبونة	لِشْبُونَة
لصاف	صافِي
لصف	صَفّ
لطمين	طَمَى-ِ
لعباء	عَباء
لعس	عَسّ
لعلع	لَعْلَع
لغابر	غابِر
لفلف	لَفْلَف
لقاع	قاع
اللقاطة	لُقاط
لقرشان	قِرْش
اللقيطة	لَقِيط
اللكمة	لَكْمَة
لمطة	مَطّ
لمغان	مَغْنَى
لنبان	أَبان
لوبيا	لُوبِياء
اللوح	لَوْح
اللور	لُور
اللوزة	لَوْز
اللوزية	لَوْزِيّ
لؤلؤة	لُؤْلُؤ
اللهيب	لَهِيب
الليث	لَيْث
ليع	وَعَى-ِ
ليلون	لَوَّن
مآب	مَآب
المئبر	مِئْبَر
المأتمة	مَأْتَمَة
ماجد	ماجِد
مارد	مارِد
ماردة	مارِد
ماردين	مارِد
مارية	مارّ
مازج	مازَج
المازحين	مازِح
مازن	مازِن
مالطة	مالْطا
ماند	وَدَى-ِ
مانق	وَقَى-ِ
ماهيان	مائِيّ
مائد	مائِد
المبارك	مُبارَك
مبرة	مَبَرَّة
المتثلم	مُتَثَلِّم
المثناة	مُثَنَّى
المجازة	مُجاز
مجدل	مَجْدَل
مجدول	مَجْدُول
مجريط	مَجْرِيط
مجسد	مُجَسَّد
مجنح	مُجَنَّح
مجيرة	مُجِير
محجن	مِحْجَن
المحجة	مَحَجَّة
المحدث	مُحْدَث
المحدثة	مُحْدَث
المحدود	مَحْدُود
المحروم	مَحْرُوم
المحلة	مَحَلَّة
المحمديات	مُحَمَّدِيّ
المحمدية	مُحَمَّدِيّ
محمر	مُحَمَّر
محمة	مِحَمّ
المحول	مُحَوِّل
المحو	مَحْو
محياه	مَحَّى
محيص	مَحِيص
محيلات	مُحِيل
المخا	مُخا
المخابط	مِخْبَط
مخايل	مَخِيلَة
المختار	مُخْتار
المختارة	مُخْتار
مختاران	مُخْتار
المخرفين	مُخَرِّف
المخرم	مُخَرَّم
مخرمة	مُخَرَّم
المخلفة	مُخَلَّف
مخمر	مُخَمَّر
مخمسة	مُخَمَّس
مخيض	مَخِيض
مخيل	مُخِيل
المخيم	مُخَيَّم
مداخل	مَدْخَل
المدار	مَدار
المدان	مُدان
المدجج	مُدَجَّج
مدبج	مُدَبَّج
المدراء	مُدِير
المدراة	مِدْراة
مدران	مُدِرّ
المدركة	مُدْرِك
مدع	مُدَّعِي
المدور	مُدَوَّر
مدلين	مُدِلّ
المديدان	مَدِيد
المذاهب	مَذْهَب
المذرى	مِذْرَى
مذود	مِذْوَد
مرابض	مَرْبِض
المرار	مِرار
مراقية	مِرْقاة
المراكب	مَرْكَب
مرانة	مِران
المربد	مُرَبَّد
مربوط	مَرْبُوط
المربوع	مَرْبُوع
مرتج	مُرْتَجّ
المرختان	مَرِخ
مردان	مَرَدّ
مرز	مَرَزّ
مرست	مَرَس
المرسلية	مُرْسَلِيَّة
مرغة	مَرَّغ
المرقبة	مَرْقَب
المرقدة	مُرَقِّد
مركوب	مَرْكُوب
مروان	مَرْوان
المروان	مَرْوان
المروحة	مِرْوَحَة
المرود	مِرْوَد
مريخ	مِرِّيخ
المرير	مَرِير
المريسة	مَرِيسَة
مريسة	مَرِيسَة
المريط	مَرِيط
مرين	مُرّ
المرية	مُرْيَة
المزاج	مِزاج
مزاحم	مُزاحِم
المزاهر	مَزاهِر
مزيد	مَزِيد
مسانة	مِسَنّ
مسبر	مِسْبَر
المستراد	مُسْتَراد
المستشرف	مُسْتَشْرَف
المسجدان	مَسْجِد
المسحاء	مَسِيح
مسحلان	مِسْحَل
المسد	مَسَد
مسطح	مُسَطَّح
مسعط	مِسْعَط
المسعودة	مَسْعُود
مسفرا	مُسْفِر
مسقط	مَسْقَط
مسلوق	مَسْلُوق
مسلية	مُسَلِّي
المسمارية	مِسْمارِيّ
المسناة	مُسَنّاة
مسور	مُسَوَّر
مسوس	مُسَوِّس
مشار	مُشار
المشارف	مَشْرَف
المشافر	مِشْفَر
مشتلة	مَشْتَل
مشرد	مُشَرَّد
مشرقين	مُشْرِق
المشقق	مُشَقَّق
المصانع	مَصْنَع
مصقلة	مِصْقَلَة
المضل	مُضِلّ
المضمار	مِضْمار
المطابخ	مَطْبَخ
مطار	مَطار
مطارة	مَطار
مطاره	مَطار
المطارد	مُطارِد
المطرية	مُطْرِي
مطلوب	مَطْلُوب
مطوعة	مُطَوِّع
مظللة	مُظَلِّل
مظلم	مُظْلِم
مظلومة	مَظْلُوم
المعا	أَلْمَع
معاذ	مَعاذ
معاذة	مَعاذ
المعرفة	مَعْرِفَة
المعركة	مَعْرَكَة
معروف	مَعْرُوف
المعشوق	مَعْشُوق
معصوب	مَعْصُوب
معقلة	مَعْقِل
معلولا	مَعْلُول
معليا	مُعَلَّى
معمران	مُعَمَّر
معمر	مُعَمَّر
المعمل	مَعْمَل
المعمورة	مَعْمُور
المعنية	مَعْنِيّ
معوز	مُعْوِز
مغارب	مَغْرِب
مغار	مَغار
المغاسل	مَغْسَل
مغنان	مُغِنّ
المغيث	مُغِيث
مفتح	مُفَتِّح
المفترض	مُفْتَرَض
مقاريب	مِقْراب
مقاس	مَقاس
المقاعد	مَقْعَد
المقترب	مُقْتَرِب
مقد	مِقَدّ
مقر	مَقَرّ
المقر	مَقَرّ
مقرون	مَقْرُون
مقرة	مَقَرّ
مقرية	مَقَرّ
المقشعر	مُقْشَعِرّ
المقطم	مُقَطَّم
مقلص	مُقَلِّص
مقمل	مُقْمَل
المقياس	مِقْياس
المكتب	مَكْتَب
مكتومة	مَكْتُوم
مكران	مَكَرّ
مكمن	مَكْمَن
مكناسة	مِكْناس
مكنونة	مَكْنُون
مكة	MANUAL
الملا	مُلّا
ملحاء	أَمْلَح
ملطمة	مَلْطَم
ملكان	مَلِك
مليح	مَلِيح
مليحة	مَلِيح
مليص	مَلِيص
مليلة	مَلِيلَّة
الممالح	مَمْلَحَة
منابض	مَنْبِض
المنارة	مَنار
مناع	مَنْعَى
المناعة	مَناعَة
منجل	مِنْجَل
منجوران	مَنْجُور
منجور	مَنْجُور
منخر	مَنْخَر
مندب	مَنْدَب
مندد	مُنَدِّد
مندل	مَنْدَل
مندوب	مَنْدُوب
المندى	مُنَدَّى
منستير	مُنَستِير
المنشار	مِنْشار
منشد	مُنْشِد
منضح	مِنْضَح
منفية	مَنْفِيّ
منهل	مَنْهَل
المنيب	مُنِيب
منيع	مَنِيع
المنيف	مُنِيف
المنيفة	مُنِيف
مواضيع	مَوْضُوع
مور	مُور
موسى	مُوسَى
الموصلان	مُوَصِّل
موضوع	مَوْضُوع
موقر	مُوَقَّر
موهبة	مَوْهِبَة
مهجور	مَهْجُور
مهجرة	مَهْجَر
كقولك	قَوْل
مهرات	مُهْرَة
المهراس	مِهْراس
مهزول	مَهْزُول
مهشمة	مُهَشَّم
مهور	مَهْر
مياسر	مَيْسَرَة
الميان	مَيّان
ميانه	مَيّان
المياه	ماء
مياة	ماء
ميدان	مَيْدان
الميدان	مَيْدان
ميدان	مَيْدان
ميسان	مَيَسان
ميسون	مَيْسُون
ميطان	مَيْط
ميغ	مِيج
ميمون	مَيْمُون
ميمة	مِيم
فاجتمعنا	ٱِجْتَمَع
نابت	ناب
نابلس	MANUAL
نابع	نابِع
نابل	نابِل
ناجرة	أَجَر
ناجية	ناجِي
النار	نار
النازية	نازِيّ
ناسر	أَسَر-ِ
ناصع	ناصِع
ناعم	ناعِم
الناعم	ناعِم
نافع	نافِع
نافقان	نافِق
نامين	نامِي
نامية	نامِي
نائين	ناءَى
نبارة	بارَى
النباريس	نِبْراس
نبايع	بايَع
نبهان	نَبِه
النبي	نَبِيّ
نجال	أَجال
النجام	نَجّام
النجب	نَجْب
النجبة	نَجْب
النجد	نَجْد
نجران	نَجْران
النجف	نَجَف
النجفة	نَجَفَة
نجه	جَهِي-َ
النجيل	نَجِيل
نحا	نَحا
النحيزة	نَحِيزَة
نخشب	خَشَّب
نخلتان	نَخْل
نساح	أَساح
النسر	نَسْر
النشاش	نَشّاش
نشير	أَشار
النصيع	نَصِيع
نضاد	ضادّ
النضير	نَضِير
نطاع	أَطاع
النطاق	نِطاق
نطاة	نَطّ
نعام	نَعام
نعامة	نَعام
نعمان	نُعْمان
النغل	نَغْل
نفار	أَفار
نفنف	نَفْنَف
نفوسة	نَفْس
نفيس	نَفِيس
النقع	نَقْع
نقمى	نَقْمَة
النقيب	نَقِيب
نقيب	نَقِيب
النقير	نَقِير
النقيرة	نَقِيرَة
نقيع	نَقِيع
النقية	نَقِيّ
النمارق	نُمْرُق
النمارة	نَمّارَة
نميسة	ماس-ِ
نوادر	نادِرَة
نواز	وازَى-ِ
النواقير	ناقُور
النوائح	نائِحَة
نوز	وَزّ
نوسا	نَوْس
نوش	وَشَّى
نوق	ناقَة
نها	نَها
نهران	نَهْر
نياع	نَيْع
نيان	نِيّ
نيقية	نَيِّق
الواحات	واحَة
الوادي	وادِي
الواديين	وادِي
واذار	آذار
واردات	وارِد
والع	لاع
وبذة	بَذّ
وبعان	عانِي
الوتائر	وَتِيرَة
الوتران	وَتَر
وج	ج
وح	ح
الوحيدان	وَحِيد
الوحيد	وَحِيد
الوحيدة	وَحِيد
وحيف	حَيْف
وخاب	خاب-ِ
وخش	خَشّ
الوداع	وَداع
ودقان	دِقّ
الوديك	وَدِيك
الوذ	لاذ
وراخ	راخِي
الوراق	وَرّاق
الوراقين	وَرّاق
وراوي	راوِي
ورثان	رَثّ
ورسك	وَرْس
ورسنان	رَسَن
ورسنين	رَسَن
وراقان	وَرّاق
الورقة	وَرَق
وركان	وَرْك
الوزيرة	وَزِير
الوسائد	وِسادَة
وسخاء	سَخاء
وسيج	سَيَّج
وسيم	وَسِيم
وشترة	شَتَر-ِ
الوشل	وَشَل
الوشم	وَشْم
وشيج	وَشِيج
الوشيع	وَشِيع
وصاب	صابِي
الوصيد	وَصِيد
الوضح	وَضَح
وعاب	عاب-ِ
الوعر	وَعْر
الوعوعة	وَعْوَعَة
الوعيرة	وَعِير
الوفاء	وَفاء
وقش	قَشّ
الوقواق	وَقْواق
الوكف	وَكْف
ولغون	لَغا
الولية	وَلِيَّة
وهران	وَهْران
ويمية	أَماه
وينا	يِن
هاب	هاب-َ
هارة	هار
الهاشمية	هاشِمِيّ
الهباءة	هَباء
الهتي	إِلٰه
الهجر	هَجْر
الهجرة	هِجْرَة
الهجيرة	هَجِيرَة
الهدار	هَدّار
الهدأة	هَدْء
الهدم	هَدْم
الهر	هِرّ
هرشى	هَرْش
هروب	هُرُوب
الهزار	هِزار
الهزر	هَزْر
الهزم	هَزْم
الهزيم	هَزِيم
هضاب	هَضْبَة
هضب	هَضَب-ِ
هضيم	هَضِيم
هفتان	هَفْتان
الهفة	لَهِف-َ
هكر	هَكِر-َ
هلال	هِلال
هلباء	أَهْلَب
الهمج	هَمَج
همزى	هَمْز
هنن	هَنّ-ِ
هني	هَنِيّ
الهور	هَوْر
هولى	هَوْل
هيثم	هَيْثَم
هيطل	هَيْطَل
هيلان	هَيَلان
يابره	أَبَر-ُِ
اليابس	يابِس
يأجج	أَجّ
يارم	أَرَم-ِ
يافا	MANUAL
يافع	يافِع
يانه	أَنَى-ِ
ياية	ياي
يبرين	بَرَى-ِ
يبوس	باس
يبة	بَهِي-َ
اليتيمة	يَتِيم
يثلث	ثَلَّث
يجودة	جاد
يذبل	ذَبَل
يرملة	رَمَّل
يرولة	رَوَّل
اليزيدية	يَزِيدِيّ
يغوث	غَوَّث
اليفاع	يَفاع
يفعان	يَفَع
يك	وَكَى-ِ
يكك	وَكَى-ِ
يلملم	لَمْلَم
اليمامة	يَمام
يمين	يَمِين
اليمينين	يَمِين
ينوف	ناف
ينوفة	ناف
يوان	يُوان
يوز	وَزّ